Name,TeamAbbreviation,GamesPlayed,Minutes,Assists,AssistPoints,TwoPtAssists,ThreePtAssists,AtRimAssists,ShortMidRangeAssists,LongMidRangeAssists,Corner3Assists,Arc3Assists
Mikal Bridges,NYK,342,11898,987,2404,557,430,339,160,58,176,254
Jayson Tatum,BOS,311,11237,1448,3675,669,779,405,193,71,264,515
Anthony Edwards,MIN,325,11229,1334,3345,657,677,449,169,39,233,444
DeMar DeRozan,SAC,310,11182,1676,4160,868,808,530,234,104,228,580
Nikola Vucevic,CHI,326,10915,1105,2729,586,519,348,106,132,173,346
Domantas Sabonis,SAC,308,10856,2126,5267,1111,1015,651,286,174,225,790
Pascal Siakam,IND,300,10755,1456,3620,748,708,491,189,68,199,509
Nikola Jokic,DEN,313,10738,2762,6445,1841,921,1324,275,242,307,614
Harrison Barnes,SAS,323,10418,654,1604,358,296,199,127,32,106,190
Fred VanVleet,HOU,281,10353,1975,4676,1249,726,745,399,105,255,471
Julius Randle,MIN,289,10342,1435,3721,584,851,355,153,76,295,556
Dejounte Murray,NOP,295,10242,1992,4699,1277,715,703,416,158,208,507
Luka Doncic,DAL,285,10230,2495,6054,1431,1064,1090,245,96,421,643
De'Aaron Fox,SAC,289,10144,1763,4290,999,764,688,255,56,186,578
Tobias Harris,DET,303,10142,932,2275,521,411,328,131,62,155,256
Trae Young,ATL,290,10122,2948,6850,1994,954,1501,366,127,361,593
Jalen Brunson,NYK,315,10114,1732,4262,934,798,638,219,77,267,531
Buddy Hield,GSW,339,10113,981,2308,635,346,414,179,42,125,221
RJ Barrett,TOR,294,9958,943,2264,565,378,401,114,50,152,226
Rudy Gobert,MIN,306,9837,396,1018,170,226,88,62,20,68,158
Kentavious Caldwell-Pope,ORL,321,9769,682,1592,454,228,298,120,36,76,152
Devin Booker,PHX,279,9748,1530,3763,827,703,495,247,85,290,413
Bam Adebayo,MIA,288,9747,1168,2906,598,570,402,147,49,127,443
Terry Rozier,MIA,286,9675,1342,3249,777,565,501,221,55,185,380
Jaylen Brown,BOS,280,9653,994,2473,509,485,360,121,28,145,340
Royce O'Neale,PHX,326,9604,921,2289,474,447,326,110,38,154,293
Giannis Antetokounmpo,MIL,285,9544,1711,4468,665,1046,410,166,89,328,718
James Harden,LAC,263,9447,2579,5980,1757,822,1110,438,209,270,552
Tyrese Haliburton,IND,285,9431,2484,5907,1545,939,1016,387,142,287,652
Darius Garland,CLE,272,9296,1978,4543,1391,587,1046,287,58,181,406
Stephen Curry,GSW,275,9275,1616,3771,1077,539,752,258,67,190,349
Russell Westbrook,DEN,306,9247,2310,5334,1596,714,1022,404,170,221,493
Jrue Holiday,BOS,283,9216,1726,4211,967,759,671,207,89,213,546
Coby White,CHI,306,9193,1222,2943,723,499,397,214,112,209,290
Donovan Mitchell,CLE,267,9177,1374,3365,757,617,571,167,19,235,382
Josh Hart,NYK,281,9159,1083,2657,592,491,395,145,52,152,339
Jarrett Allen,CLE,289,9080,566,1350,348,218,224,79,45,48,170
Keldon Johnson,SAS,299,9045,694,1671,411,283,252,108,51,93,190
Dennis Schroder,BKN,293,9011,1577,3818,913,664,587,240,86,189,475
Kyle Kuzma,WAS,280,9008,918,2192,562,356,410,106,46,144,212
Dorian Finney-Smith,BKN,290,8968,487,1195,266,221,168,65,33,70,151
CJ McCollum,NOP,262,8954,1319,3127,830,489,519,229,82,151,338
P.J. Washington,DAL,294,8941,671,1623,390,281,272,71,47,78,203
Gary Trent Jr.,MIL,286,8908,466,1128,270,196,159,85,26,55,141
Shai Gilgeous-Alexander,OKC,257,8876,1519,3813,744,775,486,191,67,213,562
Damian Lillard,MIL,247,8863,1800,4353,1047,753,756,200,91,253,500
LeBron James,LAL,250,8852,1873,4402,1217,656,919,233,65,252,404
Tyrese Maxey,PHI,282,8814,1169,2817,690,479,401,185,104,142,337
Saddiq Bey,ATL,292,8804,538,1301,313,225,209,76,28,83,142
Derrick White,BOS,289,8759,1304,3119,793,511,521,213,59,143,368
Zach LaVine,CHI,249,8735,1103,2608,701,402,376,224,101,142,260
D'Angelo Russell,LAL,277,8690,1740,4077,1143,597,825,241,77,153,444
Jordan Poole,WAS,307,8681,1214,2908,734,480,474,209,51,117,363
Kevin Huerter,SAC,304,8641,877,2072,559,318,347,165,47,113,205
Jaden McDaniels,MIN,307,8526,441,1069,254,187,180,63,11,61,126
Chris Paul,SAS,276,8451,2446,5765,1573,873,861,513,199,237,636
Aaron Gordon,DEN,277,8438,850,2014,536,314,332,138,66,90,224
Jimmy Butler,MIA,250,8402,1400,3499,701,699,435,208,58,271,428
Luguentz Dort,OKC,279,8400,485,1175,280,205,182,78,20,46,159
Andrew Wiggins,GSW,272,8377,579,1490,247,332,146,78,23,83,249
Jonas Valanciunas,WAS,319,8336,663,1526,463,200,266,120,77,26,174
Malik Beasley,DET,301,8332,482,1176,270,212,181,60,29,68,144
Tyler Herro,MIA,251,8293,1026,2487,591,435,385,165,41,158,277
Mike Conley,MIN,285,8262,1673,4035,984,689,681,258,45,179,510
Ivica Zubac,LAC,317,8236,438,1058,256,182,115,74,67,53,129
Franz Wagner,ORL,256,8204,925,2209,566,359,425,94,47,119,240
Brandon Ingram,NOP,243,8198,1321,3204,759,562,548,165,46,199,363
John Collins,UTA,278,8176,393,945,234,159,148,64,22,31,128
Deandre Ayton,POR,266,8160,409,1002,225,184,100,72,53,54,130
Deni Avdija,POR,311,8156,801,1882,521,280,353,126,42,83,197
Isaac Okoro,CLE,300,8132,506,1223,295,211,189,82,24,59,152
Kevin Durant,PHX,225,8131,1199,2820,777,422,553,167,57,126,296
Jalen Green,HOU,249,8124,811,1902,531,280,360,142,29,69,211
Clint Capela,ATL,300,8121,325,787,188,137,89,67,32,55,82
Jerami Grant,POR,240,8119,616,1519,329,287,201,83,45,86,201
Tim Hardaway Jr.,DET,284,8115,520,1277,283,237,200,54,29,94,143
OG Anunoby,NYK,231,8089,503,1226,283,220,182,73,28,80,140
Dillon Brooks,HOU,268,8066,591,1386,387,204,229,139,19,58,146
Kyrie Irving,DAL,223,8020,1236,2969,739,497,499,170,70,152,345
Grayson Allen,PHX,282,8002,635,1539,366,269,220,100,46,104,165
Anthony Davis,LAL,231,7984,726,1745,433,293,298,86,49,66,227
Kelly Oubre Jr.,PHI,269,7981,342,812,214,128,137,51,26,39,89
Jordan Clarkson,UTA,276,7967,959,2347,530,429,370,133,27,166,263
Caris LeVert,CLE,266,7926,1204,2888,724,480,530,154,40,131,349
Lauri Markkanen,UTA,251,7859,401,1000,203,198,128,53,22,72,126
Karl-Anthony Towns,NYK,236,7856,886,2116,542,344,404,97,41,124,220
Scottie Barnes,TOR,224,7831,1091,2612,661,430,451,161,49,148,282
Terance Mann,LAC,327,7808,656,1620,348,308,206,106,36,90,218
Norman Powell,LAC,268,7807,461,1133,250,211,171,62,17,79,132
Jakob Poeltl,TOR,282,7793,709,1615,512,197,275,146,91,48,149
Bobby Portis,MIL,312,7751,400,1029,171,229,116,27,28,71,158
Brook Lopez,MIL,263,7739,320,787,173,147,113,36,24,29,118
Bojan Bogdanovic,NYK,257,7718,505,1272,243,262,162,66,15,102,160
Paul George,PHI,227,7706,1068,2607,597,471,396,143,58,159,312
Draymond Green,GSW,258,7697,1836,4423,1085,751,703,270,112,151,600
Miles Bridges,CHA,226,7681,711,1776,357,354,256,70,31,120,234
Grant Williams,CHA,311,7666,484,1217,235,249,152,43,40,79,170
Donte DiVincenzo,MIN,284,7653,871,2054,559,312,389,132,38,110,202
Joel Embiid,PHI,229,7634,940,2344,476,464,296,109,71,130,334
Desmond Bane,MEM,261,7550,879,2152,485,394,299,166,20,123,271
Bradley Beal,PHX,218,7527,1115,2657,688,427,399,219,70,158,269
Kyle Lowry,PHI,240,7492,1393,3316,863,530,561,229,73,189,341
Reggie Jackson,PHI,302,7473,1126,2708,670,456,381,195,94,139,317
Immanuel Quickley,TOR,294,7442,1024,2462,610,414,443,129,38,139,275
Kyle Anderson,GSW,308,7432,1151,2707,746,405,521,185,40,120,285
Spencer Dinwiddie,DAL,247,7392,1292,3173,703,589,492,155,56,220,369
Tyus Jones,PHX,312,7386,1642,3971,955,687,574,308,73,226,461
Duncan Robinson,MIA,282,7379,541,1256,367,174,206,141,20,62,112
Bruce Brown,TOR,284,7370,712,1716,420,292,279,94,47,112,180
Myles Turner,IND,251,7326,318,750,204,114,127,53,24,31,83
Michael Porter Jr.,DEN,235,7325,337,789,222,115,144,64,14,35,80
Bogdan Bogdanovic,ATL,250,7317,759,1788,489,270,329,134,26,115,155
Evan Mobley,CLE,222,7314,622,1502,364,258,258,90,16,83,175
Anfernee Simons,POR,250,7174,911,2187,546,365,333,140,73,132,233
Ayo Dosunmu,CHI,258,7167,818,1912,542,276,310,147,85,85,191
Malik Monk,SAC,285,7120,1054,2475,687,367,501,139,47,142,225
Nicolas Batum,LAC,289,6985,535,1276,329,206,182,100,47,69,137
Al Horford,BOS,243,6960,726,1775,403,323,254,102,47,106,217
Cole Anthony,ORL,276,6952,1074,2591,631,443,408,153,70,114,329
Jaren Jackson Jr.,MEM,241,6941,341,851,172,169,102,52,18,37,132
Herbert Jones,NOP,227,6826,542,1284,342,200,199,100,43,57,143
Kristaps Porzingis,BOS,221,6760,485,1176,279,206,186,52,41,62,144
Marcus Smart,MEM,215,6759,1219,2902,755,464,550,142,63,127,337
Josh Giddey,CHI,235,6758,1372,3288,828,544,601,168,59,172,372
Georges Niang,CLE,333,6749,367,881,220,147,152,53,15,52,95
Khris Middleton,MIL,224,6741,1194,2792,790,404,595,157,38,127,277
Cameron Johnson,BKN,249,6721,467,1140,261,206,151,87,23,76,130
Isaiah Stewart,DET,260,6652,331,805,188,143,88,59,41,23,120
Wendell Carter Jr.,ORL,241,6651,530,1256,334,196,186,88,60,44,152
Rui Hachimura,LAL,249,6649,302,757,149,153,93,35,21,38,115
Pat Connaughton,MIL,286,6640,427,1037,244,183,135,73,36,66,117
Devin Vassell,SAS,248,6635,630,1539,351,279,214,108,29,90,189
Reggie Bullock Jr.,HOU,255,6633,305,743,172,133,106,46,20,52,81
Caleb Martin,PHI,268,6607,436,1098,210,226,134,58,18,71,155
Max Strus,CLE,257,6605,570,1334,376,194,235,116,25,65,129
Ja Morant,MEM,204,6602,1534,3631,971,563,668,252,51,210,353
Eric Gordon,PHI,237,6580,568,1363,341,227,239,85,17,70,157
Austin Reaves,LAL,226,6531,867,2069,532,335,393,93,46,117,218
Corey Kispert,WAS,250,6487,356,836,232,124,126,66,40,27,97
LaMelo Ball,CHA,202,6484,1489,3465,1002,487,744,201,57,144,343
Kelly Olynyk,TOR,257,6476,914,2148,594,320,443,120,31,100,220
De'Andre Hunter,ATL,214,6450,311,765,168,143,97,47,24,47,96
Alperen Sengun,HOU,234,6449,916,2194,554,362,380,107,67,77,285
Mason Plumlee,PHX,276,6416,765,1844,451,314,287,100,64,98,216
Nic Claxton,BKN,244,6409,404,975,237,167,101,76,60,40,127
Kevon Looney,GSW,320,6394,660,1646,334,326,145,110,79,54,272
Naz Reid,MIN,319,6345,363,898,191,172,113,66,12,60,112
Patrick Williams,CHI,228,6336,315,781,164,151,109,31,24,51,100
Jusuf Nurkic,PHX,237,6314,753,1798,461,292,259,110,92,75,217
Jamal Murray,DEN,189,6311,1121,2604,759,362,431,252,76,94,268
Collin Sexton,UTA,220,6293,880,2125,515,365,326,164,25,98,267
Alex Caruso,OKC,252,6276,798,1855,539,259,358,120,61,78,181
Malcolm Brogdon,WAS,207,6215,1026,2491,587,439,411,118,58,132,307
Josh Richardson,MIA,240,6176,559,1356,321,238,179,110,32,66,172
Daniel Gafford,DAL,301,6139,325,755,220,105,103,70,47,24,81
Jeff Green,HOU,284,6122,344,839,193,151,118,45,30,35,116
KJ Martin,PHI,285,6122,340,862,158,182,106,35,17,46,136
Alec Burks,MIA,259,6087,564,1356,336,228,230,74,32,73,155
Klay Thompson,DAL,198,6055,463,1078,311,152,203,95,13,47,105
Christian Wood,LAL,226,6030,396,954,234,162,176,46,12,51,111
Taurean Prince,MIL,265,6005,390,911,259,131,180,56,23,57,74
De'Anthony Melton,GSW,246,5996,654,1555,407,247,272,101,34,85,162
Seth Curry,CHA,249,5884,536,1286,322,214,184,90,48,70,144
Gordon Hayward,OKC,194,5882,722,1758,408,314,300,86,22,96,218
Keegan Murray,SAC,182,5881,266,650,148,118,83,47,18,46,72
Jae'Sean Tate,HOU,254,5867,554,1417,245,309,189,39,17,66,243
Kawhi Leonard,LAC,172,5850,717,1817,334,383,193,97,44,136,247
Nickeil Alexander-Walker,MIN,275,5830,628,1503,381,247,260,100,21,75,172
Monte Morris,PHX,235,5821,908,2178,546,362,298,179,69,92,270
Justin Holiday,DEN,249,5808,355,833,232,123,159,56,17,38,85
Cedi Osman,SAS,274,5789,543,1301,328,215,236,77,15,74,141
Chris Boucher,TOR,289,5784,155,372,93,62,68,14,11,12,50
T.J. McConnell,IND,266,5746,1471,3542,871,600,669,156,46,204,396
P.J. Tucker,LAC,229,5743,286,735,123,163,89,23,11,40,123
Luke Kennard,MEM,245,5742,518,1268,286,232,184,90,12,79,153
Marcus Morris Sr.,CLE,225,5708,321,795,168,153,108,45,15,65,88
Tre Jones,SAS,259,5679,1224,2967,705,519,452,198,55,141,378
Matisse Thybulle,POR,267,5671,281,678,165,116,102,44,19,32,84
Jabari Smith Jr.,HOU,179,5594,243,574,155,88,114,35,6,22,66
Patrick Beverley,MIL,235,5587,750,1796,454,296,280,94,80,95,201
Gary Harris,ORL,219,5574,339,824,193,146,124,47,22,46,100
Isaiah Hartenstein,OKC,279,5536,541,1280,343,198,226,77,40,65,133
Derrick Jones Jr.,LAC,274,5519,209,527,100,109,57,21,22,33,76
Jarred Vanderbilt,LAL,245,5481,390,974,196,194,137,40,19,58,136
Killian Hayes,DET,210,5478,1090,2635,635,455,409,172,54,158,297
Devonte' Graham,SAS,227,5472,856,2014,554,302,365,145,44,90,212
Torrey Craig,CHI,266,5462,318,765,189,129,97,64,28,49,80
Delon Wright,MIL,255,5451,808,2014,410,398,238,121,51,125,273
Robert Covington,PHI,218,5449,290,722,148,142,107,30,11,30,112
Lonnie Walker IV,BKN,244,5442,391,934,239,152,160,47,32,47,105
Payton Pritchard,BOS,291,5414,673,1672,347,326,235,76,36,102,224
Paolo Banchero,ORL,157,5411,728,1758,426,302,300,85,41,83,219
Trey Murphy III,NOP,210,5400,304,731,181,123,112,46,23,39,84
Onyeka Okongwu,ATL,256,5398,261,643,140,121,75,43,22,34,87
Zion Williamson,NOP,166,5376,743,1917,312,431,174,81,57,140,291
Talen Horton-Tucker,CHI,260,5345,791,1898,475,316,307,124,44,110,206
Jalen Suggs,ORL,201,5329,666,1600,398,268,303,67,28,88,180
Cade Cunningham,DET,159,5316,1089,2569,698,391,510,149,39,129,262
Davion Mitchell,TOR,251,5286,755,1844,421,334,271,123,27,110,224
Precious Achiuwa,NYK,265,5266,263,652,137,126,88,27,22,37,89
Andre Drummond,PHI,284,5259,305,717,198,107,120,51,27,43,64
Jaden Ivey,DET,175,5254,785,1879,476,309,308,139,29,120,189
Jalen Williams,OKC,169,5230,687,1670,391,296,275,86,30,86,210
Joe Ingles,MIN,233,5228,838,1976,538,300,382,121,35,119,181
Doug McDermott,SAC,264,5216,313,740,199,114,106,71,22,46,68
Dwight Powell,DAL,297,5211,326,792,186,140,80,47,59,36,104
Kevin Porter Jr.,LAC,168,5196,942,2272,554,388,413,112,29,73,315
Aaron Nesmith,IND,249,5190,257,610,161,96,103,44,14,29,67
Obi Toppin,IND,307,5176,343,834,195,148,123,58,14,53,95
Patty Mills,UTA,230,5150,448,1034,310,138,181,77,52,35,103
Josh Green,CHA,245,5135,377,941,190,187,139,33,18,73,114
Shake Milton,BKN,262,5115,673,1623,396,277,245,118,33,100,177
Jae Crowder,SAC,200,5113,348,828,216,132,118,66,32,62,70
Mitchell Robinson,NYK,193,5058,126,312,66,60,32,18,16,12,48
Jonathan Kuminga,GSW,232,5042,390,993,177,213,96,60,21,60,153
Drew Eubanks,UTA,298,5023,317,785,166,151,81,46,39,36,115
Will Barton,TOR,183,5005,569,1333,374,195,217,124,33,61,134
Naji Marshall,DAL,250,4966,515,1208,337,178,235,67,35,57,121
Cameron Payne,NYK,261,4932,975,2338,587,388,325,189,73,131,257
Kenrich Williams,OKC,250,4901,469,1136,271,198,174,76,21,55,143
Larry Nance Jr.,ATL,217,4893,434,1053,249,185,144,59,46,54,131
Steven Adams,HOU,189,4882,478,1081,353,125,192,98,63,23,102
Maxi Kleber,DAL,203,4829,264,673,119,145,56,45,18,57,88
Garrison Mathews,ATL,268,4772,180,435,105,75,73,29,3,27,48
Cam Thomas,BKN,207,4766,405,961,254,151,180,59,15,59,92
Moritz Wagner,ORL,271,4704,355,869,196,159,122,45,29,34,125
John Konchar,MEM,254,4688,377,939,192,185,119,58,15,55,130
Gabe Vincent,LAL,221,4674,485,1178,277,208,166,87,24,80,128
Evan Fournier,DET,181,4656,399,963,234,165,141,62,31,47,118
Trey Lyles,SAC,248,4653,257,628,143,114,91,40,12,37,77
Amir Coffey,LAC,257,4623,306,756,162,144,95,51,16,49,95
Cory Joseph,ORL,229,4615,718,1769,385,333,213,115,57,98,235
Kevin Love,MIA,228,4595,470,1067,343,127,231,98,14,40,87
Bennedict Mathurin,IND,162,4579,278,684,150,128,95,43,12,38,90
Dean Wade,CLE,229,4567,231,572,121,110,79,29,13,29,81
Jevon Carter,CHI,290,4489,464,1131,261,203,131,85,45,55,148
Aaron Holiday,HOU,284,4445,523,1271,298,225,193,70,35,63,162
Marvin Bagley III,WAS,199,4437,176,437,91,85,54,21,16,24,61
Darius Bazley,UTA,176,4406,241,606,117,124,81,24,12,33,91
Quentin Grimes,DAL,190,4382,292,702,174,118,121,39,14,45,73
Landry Shamet,WAS,216,4373,354,835,227,127,130,77,20,41,86
Santi Aldama,MEM,195,4331,337,828,183,154,119,50,14,39,115
Brandon Clarke,MEM,209,4330,286,677,181,105,99,61,21,22,83
Isaiah Joe,OKC,268,4289,277,679,152,125,104,41,7,42,83
Troy Brown Jr.,DET,235,4264,250,602,148,102,94,33,21,27,75
Joe Harris,DET,173,4261,255,618,147,108,95,33,19,47,61
Jalen McDaniels,TOR,232,4249,278,679,155,123,94,44,17,35,88
Cody Martin,CHA,182,4230,437,1069,242,195,175,42,25,59,136
Josh Okogie,PHX,253,4217,265,638,157,108,105,35,17,35,73
Aaron Wiggins,OKC,221,4214,271,649,164,107,117,34,13,30,77
Mo Bamba,LAC,233,4193,215,522,123,92,66,38,19,23,69
Terrence Ross,PHX,172,4125,319,758,199,120,126,52,21,42,78
Xavier Tillman Sr.,BOS,242,4080,316,769,179,137,95,54,30,35,102
Cam Reddish,LAL,180,4075,201,476,127,74,92,29,6,19,55
Andrew Nembhard,IND,154,4043,669,1592,415,254,276,110,29,66,188
Jaxson Hayes,LAL,258,4040,154,381,81,73,40,26,15,13,60
Jalen Duren,DET,151,4000,276,632,196,80,108,49,39,27,53
Jeremy Sochan,SAS,141,3958,419,1009,248,171,147,64,37,44,127
Daniel Theis,NOP,196,3944,240,580,140,100,76,40,24,22,78
Montrezl Harrell,PHI,197,3902,251,591,162,89,94,45,23,22,67
Jalen Johnson,ATL,171,3887,416,985,263,153,178,67,18,70,83
Damion Lee,PHX,198,3879,240,587,133,107,77,44,12,34,73
Robert Williams III,POR,161,3863,280,699,141,139,78,37,26,27,112
Tre Mann,CHA,181,3857,415,1016,229,186,152,66,11,36,150
Chuma Okeke,ORL,189,3831,276,677,151,125,102,33,16,37,88
Zach Collins,SAS,184,3809,477,1077,354,123,227,81,46,25,98
Oshae Brissett,BOS,208,3796,178,453,81,97,54,16,11,32,65
Richaun Holmes,WAS,191,3778,183,442,107,76,73,21,13,19,57
Ben Simmons,BKN,133,3767,858,2148,426,432,226,115,85,126,306
Theo Maledon,PHX,177,3753,518,1264,290,228,205,66,19,65,163
Thaddeus Young,PHX,207,3732,527,1225,356,171,245,65,46,49,122
Jalen Smith,CHI,229,3730,172,397,119,53,60,44,15,11,42
Walker Kessler,UTA,155,3691,153,394,65,88,27,34,4,31,57
Nick Richards,CHA,209,3647,123,289,80,43,47,19,14,10,33
Sam Hauser,BOS,205,3631,184,466,86,98,51,28,7,32,66
Christian Braun,DEN,180,3610,232,556,140,92,80,43,17,32,60
Ochai Agbaji,TOR,161,3590,198,480,114,84,66,36,12,26,58
Danilo Gallinari,MIL,166,3523,232,563,133,99,78,39,16,30,69
Bismack Biyombo,OKC,202,3520,213,497,142,71,54,52,36,22,49
Dennis Smith Jr.,BKN,170,3507,673,1611,408,265,283,94,31,88,177
Hamidou Diallo,WAS,168,3496,230,567,123,107,76,28,19,33,74
Carmelo Anthony,LAL,138,3483,172,428,88,84,62,12,14,30,54
Eric Bledsoe,LAC,125,3472,493,1179,300,193,195,75,30,60,133
Jose Alvarado,NOP,182,3454,504,1169,343,161,220,93,30,50,111
Danny Green,PHI,144,3445,189,445,122,67,76,29,17,26,41
Davis Bertans,CHA,201,3436,136,316,92,44,63,13,16,15,29
Aleksej Pokusevski,CHA,168,3429,327,792,189,138,121,46,22,43,95
Ziaire Williams,BKN,171,3403,199,473,124,75,76,43,5,28,47
Malaki Branham,SAS,159,3377,304,714,198,106,121,65,12,27,79
Jaylen Nowell,NOP,190,3367,361,871,212,149,144,56,12,56,93
Wesley Matthews,ATL,195,3365,147,356,85,62,47,27,11,14,48
Jordan Nwora,TOR,206,3358,216,510,138,78,104,24,10,29,49
Austin Rivers,MIN,155,3341,246,613,125,121,67,40,18,37,84
Shaedon Sharpe,POR,128,3326,226,558,120,106,72,32,16,27,79
Keita Bates-Diop,BKN,209,3318,194,478,104,90,57,36,11,26,64
Chimezie Metu,DET,213,3315,174,426,96,78,70,22,4,24,54
Ricky Rubio,CLE,135,3308,773,1841,478,295,348,101,29,73,222
Jordan McLaughlin,SAC,232,3302,650,1571,379,271,282,77,20,95,176
Raul Neto,CLE,182,3280,442,1056,270,172,166,70,34,45,127
Javonte Green,NOP,171,3264,125,295,80,45,51,20,9,22,23
Markelle Fultz,ORL,129,3263,603,1475,334,269,233,63,38,81,188
Rudy Gay,UTA,174,3211,201,488,115,86,76,26,13,29,57
Chris Duarte,CHI,172,3207,226,525,153,73,108,37,8,24,49
Lamar Stevens,MEM,203,3193,130,326,64,66,42,15,7,17,49
Ish Smith,CHA,195,3188,661,1584,399,262,278,82,39,86,176
Goga Bitadze,ORL,216,3182,249,595,152,97,99,33,20,15,82
Dyson Daniels,ATL,143,3176,374,876,246,128,155,67,24,49,79
Nassir Little,PHX,189,3163,148,384,60,88,31,17,12,25,63
Furkan Korkmaz,PHI,194,3129,256,616,152,104,101,35,16,39,65
R.J. Hampton,MIA,170,3116,307,774,147,160,103,29,15,46,114
Garrett Temple,TOR,175,3108,244,578,154,90,97,48,9,29,61
Trendon Watford,BKN,184,3106,307,737,184,123,124,40,20,32,91
Lonzo Ball,CHI,98,3094,521,1196,367,154,272,62,33,49,105
Brandon Miller,CHA,94,3071,244,596,136,108,100,24,12,31,77
Bones Hyland,LAC,172,3039,466,1100,298,168,209,67,22,65,103
Malachi Flynn,DET,213,3032,407,984,237,170,147,67,23,63,107
Haywood Highsmith,MIA,159,3006,142,356,70,72,43,20,7,35,37
Svi Mykhailiuk,UTA,201,3003,251,604,149,102,106,33,10,37,65
JaMychal Green,GSW,182,3002,163,411,78,85,45,21,12,18,67
Danuel House Jr.,PHI,168,2975,185,455,100,85,68,25,7,33,52
DeAndre Jordan,DEN,190,2948,182,425,121,61,64,34,23,11,50
Moses Moody,GSW,204,2938,151,375,78,73,48,21,9,22,51
Paul Reed,DET,226,2932,169,398,109,60,77,24,8,16,44
Miles McBride,NYK,190,2922,276,695,133,143,87,34,12,50,93
Dario Saric,DEN,181,2910,294,699,183,111,102,57,24,34,77
Bryn Forbes,MIN,170,2908,137,340,71,66,46,17,8,26,40
Ty Jerome,CLE,152,2860,450,1105,245,205,158,61,26,68,137
Juan Toscano-Anderson,SAC,189,2854,346,856,182,164,128,38,16,54,110
Isaiah Roby,SAS,148,2847,216,515,133,83,81,38,14,19,64
Simone Fontecchio,DET,141,2825,163,388,101,62,60,35,6,30,32
James Wiseman,IND,148,2799,110,260,70,40,25,28,17,5,35
Tristan Thompson,CLE,168,2790,156,387,81,75,36,26,19,10,65
Mike Muscala,OKC,194,2783,136,336,72,64,48,18,6,12,52
Kris Dunn,LAC,131,2764,524,1276,296,228,200,85,11,71,157
George Hill,IND,130,2758,303,735,174,129,103,41,30,34,95
Tari Eason,HOU,126,2752,139,336,81,58,55,24,2,20,38
Jeremiah Robinson-Earl,NOP,156,2743,143,353,76,67,40,24,12,19,48
Victor Wembanyama,SAS,90,2717,343,785,244,99,183,44,17,31,68
Keyonte George,UTA,97,2717,456,1092,276,180,149,112,15,69,111
Taj Gibson,CHA,178,2717,120,297,63,57,33,18,12,17,40
Blake Griffin,BOS,143,2714,306,763,155,151,78,36,41,33,118
Goran Dragic,MIL,129,2704,456,1081,287,169,194,61,32,61,108
Khem Birch,TOR,142,2682,152,382,74,78,27,22,25,23,55
Chet Holmgren,OKC,92,2677,220,517,143,77,86,35,22,20,57
Facundo Campazzo,DAL,138,2661,461,1141,242,219,147,70,25,58,161
Derrick Rose,MEM,127,2652,436,1058,250,186,172,57,21,65,121
David Roddy,ATL,149,2640,158,385,89,69,65,18,6,28,41
Gary Payton II,GSW,170,2636,170,422,88,82,58,21,9,17,65
Kendrick Nunn,WAS,126,2614,238,552,162,76,118,33,11,14,62
Stanley Johnson,SAS,139,2569,236,573,135,101,97,27,11,24,77
Yuta Watanabe,MEM,180,2560,124,300,72,52,47,23,2,20,32
Luke Kornet,BOS,196,2545,180,466,74,106,47,18,9,22,84
JaVale McGee,SAC,208,2544,109,249,78,31,46,24,8,3,28
Jabari Walker,POR,147,2524,118,281,73,45,48,19,6,11,34
Brandin Podziemski,GSW,96,2510,348,846,198,150,111,61,26,34,116
Jaime Jaquez Jr.,MIA,93,2499,237,574,137,100,85,37,15,37,63
Julian Champagnie,SAS,115,2499,149,349,98,51,72,20,6,16,35
Jock Landale,HOU,193,2486,192,476,100,92,53,24,23,19,73
Zeke Nnaji,DEN,209,2472,80,198,42,38,20,13,9,7,31
Kemba Walker,DAL,89,2461,362,889,197,165,117,52,28,44,121
James Johnson,IND,143,2460,253,618,141,112,79,40,22,29,83
Toumani Camara,POR,94,2459,137,334,77,60,46,21,10,17,43
Terence Davis,SAC,155,2451,190,447,123,67,86,28,9,26,41
Bilal Coulibaly,WAS,84,2441,176,425,103,73,72,29,2,14,59
Isaiah Jackson,IND,163,2438,116,268,80,36,45,21,14,11,25
Dalano Banton,POR,171,2399,320,774,186,134,123,45,18,55,79
Josh Jackson,SAC,113,2390,197,458,133,64,113,16,4,18,46
Victor Oladipo,MIA,83,2359,325,786,189,136,127,55,7,40,96
Thomas Bryant,MIA,144,2348,96,231,57,39,31,15,11,8,31
Alex Len,SAC,195,2334,171,438,75,96,33,32,10,20,76
Robin Lopez,MIL,160,2329,132,322,74,58,45,19,10,10,48
Otto Porter Jr.,TOR,114,2329,165,406,89,76,57,20,12,20,56
Damian Jones,CLE,175,2309,128,321,63,65,33,22,8,17,48
Nerlens Noel,BKN,106,2303,79,182,55,24,35,7,13,5,19
Cason Wallace,OKC,105,2297,169,400,107,62,76,28,3,13,49
Bol Bol,PHX,165,2252,99,237,60,39,45,7,8,11,28
Jericho Sims,NYK,161,2249,86,216,42,44,18,16,8,13,31
Peyton Watson,DEN,125,2222,125,294,81,44,50,21,10,8,36
Lou Williams,ATL,122,2222,330,791,199,131,150,30,19,48,83
Tomas Satoransky,WAS,113,2213,455,1082,283,172,197,61,25,51,121
Scoot Henderson,POR,79,2211,423,1032,237,186,145,61,31,64,122
Kevin Knox II,DET,166,2199,85,203,52,33,34,12,6,8,25
Ben McLemore,POR,117,2190,98,239,55,43,42,10,3,13,30
Elfrid Payton,NOP,120,2177,350,825,225,125,147,46,32,37,88
Enes Freedom,BOS,107,2169,92,232,44,48,23,6,15,7,41
Jordan Goodwin,MEM,121,2167,323,766,203,120,107,72,24,34,86
Dwight Howard,LAL,129,2166,96,218,70,26,31,19,20,4,22
Willy Hernangomez,NOP,133,2143,146,347,91,55,45,24,22,9,46
Josh Christopher,HOU,138,2120,223,534,135,88,109,22,4,12,76
Markieff Morris,DAL,142,2088,145,348,87,58,58,18,11,17,41
Justise Winslow,POR,103,2058,232,541,155,77,101,41,13,21,56
Andre Iguodala,GSW,102,2054,275,671,154,121,106,39,9,29,92
Isaiah Livers,DET,94,2051,87,214,47,40,24,17,6,16,24
John Wall,LAC,74,2043,453,1121,238,215,175,44,19,73,142
Amen Thompson,HOU,86,2034,211,518,115,96,71,28,16,20,76
JT Thor,CLE,168,2027,84,207,45,39,29,12,4,9,30
Jaden Hardy,DAL,143,2018,201,484,119,82,95,20,4,33,49
Serge Ibaka,MIL,111,2018,127,311,70,57,34,21,15,17,40
D.J. Augustin,LAL,112,2012,295,709,176,119,122,33,21,29,90
Avery Bradley,LAL,89,2008,93,221,58,35,43,10,5,13,22
DeAndre' Bembry,MIL,107,1998,173,423,96,77,61,22,13,25,52
Brandon Boston Jr.,NOP,127,1961,158,381,93,65,60,25,8,12,53
Juancho Hernangomez,TOR,134,1958,80,207,33,47,23,7,3,16,31
Saben Lee,PHX,134,1943,378,906,228,150,142,61,25,46,104
Day'Ron Sharpe,BKN,144,1908,142,332,94,48,54,23,17,18,30
Frank Jackson,UTA,94,1907,92,230,46,46,31,9,6,14,32
Anthony Gill,WAS,197,1903,112,271,65,47,40,17,8,11,36
Max Christie,LAL,131,1899,110,270,60,50,35,19,6,14,36
Romeo Langford,SAS,109,1898,84,200,52,32,30,17,5,14,18
Cody Zeller,NOP,133,1896,157,386,85,72,44,20,21,24,48
Gradey Dick,TOR,79,1885,107,260,61,46,46,14,1,18,28
Sterling Brown,LAL,104,1881,108,265,59,49,49,7,3,22,27
Kent Bazemore,LAL,106,1878,142,343,83,59,58,13,12,12,47
Dwayne Bacon,ORL,72,1853,93,232,47,46,23,8,16,9,37
Sam Merrill,CLE,123,1835,174,427,95,79,62,24,9,35,44
Wayne Ellington,LAL,89,1822,97,231,60,37,49,5,6,15,22
Tony Snell,NOP,100,1815,87,217,44,43,24,15,5,10,33
Jaylin Williams,OKC,118,1811,186,454,104,82,50,25,29,23,59
Moses Brown,IND,150,1804,22,48,18,4,5,7,6,0,4
Jake LaRavia,MEM,95,1804,167,406,95,72,58,37,0,21,51
Anthony Black,ORL,95,1787,191,463,110,81,83,21,6,29,52
Trent Forrest,ATL,151,1758,281,696,147,134,83,49,15,45,89
Blake Wesley,SAS,117,1757,293,730,149,144,86,49,14,31,113
Kira Lewis Jr.,UTA,131,1745,233,557,142,91,96,38,8,31,60
Nemanja Bjelica,GSW,108,1738,228,550,134,94,93,31,10,31,63
Timothe Luwawu-Cabarrot,ATL,110,1735,109,264,63,46,38,19,6,24,22
Dereck Lively II,DAL,74,1734,103,258,51,52,22,19,10,12,40
LaMarcus Aldridge,BKN,73,1725,91,234,39,52,23,8,8,10,42
Caleb Houstan,ORL,126,1716,59,157,20,39,15,3,2,16,23
Hassan Whiteside,UTA,101,1708,46,116,22,24,18,2,2,6,18
Wenyen Gabriel,MEM,120,1704,64,162,30,34,20,8,2,10,24
Dewayne Dedmon,PHI,121,1702,85,208,47,38,27,11,9,9,29
Jeremy Lamb,SAC,92,1701,134,316,86,48,57,23,6,15,33
Derrick Favors,OKC,107,1692,69,188,19,50,7,7,5,13,37
Sandro Mamukelashvili,SAS,147,1679,139,336,81,58,56,21,4,9,49
Bryce McGowens,POR,106,1671,106,248,70,36,44,14,12,10,26
Ausar Thompson,DET,68,1659,134,323,79,55,54,15,10,16,39
Frank Ntilikina,CHA,143,1657,150,368,82,68,51,23,8,22,46
Kessler Edwards,DAL,141,1656,69,178,29,40,13,8,8,18,22
Solomon Hill,ATL,84,1653,87,215,46,41,26,14,6,11,30
Rodney Hood,LAC,107,1652,91,236,37,54,24,9,4,7,47
Maurice Harkless,SAC,84,1635,67,161,40,27,27,10,3,9,18
Anthony Lamb,GSW,88,1618,121,313,50,71,28,16,6,18,53
Kris Murray,POR,83,1615,94,235,47,47,32,13,2,12,35
Lindy Waters III,GSW,123,1609,101,256,47,54,29,16,2,23,31
Bruno Fernando,TOR,162,1607,112,270,66,46,31,21,14,8,38
Edmond Sumner,BKN,106,1597,117,278,73,44,46,17,10,16,28
Vince Williams Jr.,MEM,70,1586,188,460,104,84,64,35,5,27,57
AJ Griffin,ATL,92,1572,78,187,47,31,22,21,4,5,26
Marcus Sasser,DET,87,1562,260,631,149,111,85,51,13,30,81
Keon Johnson,BKN,104,1547,162,389,97,65,65,22,10,12,53
PJ Dozier,MIN,91,1538,136,325,83,53,56,19,8,22,31
Paul Millsap,PHI,89,1538,127,310,71,56,42,17,12,17,39
Vit Krejci,ATL,92,1529,140,348,72,68,44,23,5,24,44
Keon Ellis,SAC,96,1521,118,293,61,57,42,14,5,25,32
Trayce Jackson-Davis,GSW,89,1503,126,316,62,64,28,25,9,15,49
Rodney McGruder,DET,99,1472,92,220,56,36,37,13,6,10,26
Armoni Brooks,BKN,84,1468,97,234,57,40,43,12,2,9,31
Rajon Rondo,CLE,84,1467,369,899,208,161,136,46,26,34,127
Jordan Hawkins,NOP,78,1463,84,204,48,36,32,13,3,17,19
Vasilije Micic,CHA,73,1459,312,758,178,134,123,44,11,39,95
Eric Paschall,UTA,98,1431,87,233,28,59,16,9,3,17,42
DeMarcus Cousins,DEN,89,1430,147,366,75,72,53,10,12,31,41
AJ Green,MIL,113,1414,72,183,33,39,15,8,10,6,33
Jonathan Isaac,ORL,90,1393,41,93,30,11,21,5,4,2,9
Thanasis Antetokounmpo,MIL,176,1386,100,254,46,54,28,7,11,11,43
Vlatko Cancar,DEN,120,1381,111,271,62,49,42,12,8,13,36
Brad Wanamaker,WAS,84,1373,229,564,123,106,78,31,14,29,77
CJ Elleby,POR,88,1367,97,224,67,30,50,14,3,6,24
Mark Williams,CHA,65,1366,43,107,22,21,10,4,8,9,12
Duane Washington Jr.,PHX,79,1362,148,338,106,42,78,22,6,12,30
Semi Ojeleye,LAC,86,1356,46,109,29,17,16,10,3,3,14
Nikola Jovic,MIA,75,1355,118,295,59,59,42,12,5,16,43
Trey Burke,DAL,104,1355,138,338,76,62,49,15,12,20,42
MarJon Beauchamp,MIL,111,1343,67,165,36,31,27,7,2,12,19
Ish Wainright,PHX,116,1336,69,173,34,35,18,11,5,16,19
Omer Yurtseven,UTA,113,1335,80,194,46,34,34,8,4,9,25
Trevor Ariza,LAL,54,1303,82,205,41,41,30,8,3,14,27
Duop Reath,POR,81,1297,70,162,48,22,26,13,9,3,19
David Nwaba,HOU,76,1288,66,162,36,30,34,2,0,8,22
Gorgui Dieng,SAS,113,1282,135,319,86,49,49,19,18,11,38
Tony Bradley,CHI,109,1266,65,150,45,20,18,13,14,7,13
Denzel Valentine,UTA,86,1258,116,286,62,54,43,13,6,18,36
Jalen Wilson,BKN,66,1240,84,213,39,45,24,13,2,10,35
Daishen Nix,MIN,99,1239,181,421,122,59,98,20,4,15,44
GG Jackson II,MEM,48,1233,59,140,37,22,20,16,1,7,15
Dalen Terry,CHI,122,1231,126,305,73,53,49,14,10,17,36
Usman Garuba,GSW,105,1227,82,195,51,31,36,12,3,10,21
Dante Exum,DAL,61,1204,170,406,104,66,71,24,9,17,49
Jared Butler,WAS,105,1182,243,571,158,85,109,40,9,29,56
Johnny Davis,WAS,95,1178,65,156,39,26,29,8,2,2,24
Terry Taylor,CHI,95,1165,61,158,25,36,18,4,3,8,28
Scotty Pippen Jr.,MEM,52,1142,236,578,130,106,87,38,5,29,77
Frank Kaminsky,HOU,92,1131,124,294,78,46,41,26,11,21,25
Brandon Goodwin,CLE,83,1121,186,449,109,77,64,27,18,16,61
Ousmane Dieng,OKC,88,1119,96,231,57,39,43,11,3,16,23
Skylar Mays,LAL,105,1111,182,439,107,75,65,27,15,26,49
Ben Sheppard,IND,70,1086,70,163,47,23,28,17,2,7,16
Joshua Primo,LAC,56,1069,99,232,65,34,42,19,4,14,20
Eugene Omoruyi,WAS,87,1057,65,143,52,13,34,15,3,0,13
