Name,TeamAbbreviation,GamesPlayed,Minutes,PlusMinus,OnOffRtg,OnDefRtg,FirstChancePoints,ThreePtOffReboundedPct,AtRimOffReboundedPct,ShortMidRangeOffReboundedPct,LongMidRangeOffReboundedPct,Blocks,Blocked2s,Blocked3s,BlockedAtRim,BlockedShortMidRange,BlockedLongMidRange,BlockedCorner3,BlockedArc3,RecoveredBlocks,BlocksRecoveredPct,Steals,LostBallSteals,BadPassSteals,DefensiveGoaltends
Mikal Bridges,NYK,342,11898,918,117.40431367659893,113.42435056851191,5207,0.22434150772025432,0.34265734265734266,0.2957983193277311,0.17424242424242425,202,192,10,113,72,7,3,7,120,0.594059406,369,85,284,3
Jayson Tatum,BOS,311,11237,2130,120.24311040898719,111.21820262300854,7913,0.23604368932038836,0.3629191321499014,0.3379501385041551,0.23648648648648649,186,165,21,76,76,13,3,18,106,0.5698924731182796,331,115,216,9
Anthony Edwards,MIN,325,11229,553,115.39722246183041,113.10972977639645,7005,0.21756225425950196,0.3323353293413174,0.31587301587301586,0.21311475409836064,196,180,16,97,74,9,6,10,107,0.5459183673469388,445,178,267,6
DeMar DeRozan,SAC,310,11182,35,115.55839351770301,115.73043631867161,7063,0.24552429667519182,0.3763440860215054,0.2693726937269373,0.21363636363636362,131,129,2,73,54,2,1,1,73,0.5572519083969466,326,101,225,1
Nikola Vucevic,CHI,326,10915,-653,112.88360146005138,116.12976099037635,5464,0.1707070707070707,0.3486682808716707,0.18523002421307505,0.10462287104622871,255,249,6,164,83,2,1,5,157,0.615686275,265,67,198,4
Domantas Sabonis,SAC,308,10856,285,116.27564016624211,115.61685686045466,4964,0.16615384615384615,0.36075949367088606,0.23837209302325582,0.12121212121212122,157,154,3,92,59,3,2,1,106,0.6751592356687898,290,78,212,9
Pascal Siakam,IND,300,10755,596,117.01503483681702,114.61407621937204,5925,0.21468926553672316,0.36116910229645094,0.326984127,0.1675,146,128,18,79,48,1,6,12,91,0.6232876712328768,300,134,166,5
Nikola Jokic,DEN,313,10738,2323,122.92598338961395,112.95947868386031,7047,0.1855123674911661,0.4981751824817518,0.3560145808019441,0.13306451612903225,240,240,0,117,117,6,0,0,147,0.6125,433,106,327,0
Harrison Barnes,SAS,323,10418,-232,116.66666666666667,117.9989781225324,4219,0.23705408515535098,0.37770897832817335,0.29107981220657275,0.13333333333333333,52,50,2,25,24,1,1,1,33,0.6346153846153846,214,64,150,1
Fred VanVleet,HOU,281,10353,860,115.93926081558591,112.39621826558526,4773,0.2935656836461126,0.4201954397394137,0.36658354114713215,0.23738872403560832,179,167,12,66,89,12,4,8,108,0.6033519553072626,456,280,176,0
Julius Randle,MIN,289,10342,412,114.94396613919484,113.4041525832931,5733,0.19444444444444445,0.4456066945606695,0.31343283582089554,0.20843091334894615,93,90,3,69,16,5,3,0,57,0.6129032258064516,209,78,131,1
Dejounte Murray,NOP,295,10242,-173,115.61088102409639,116.53476540418315,5489,0.21481481481481482,0.4009546539379475,0.31316725978647686,0.21811460258780038,77,69,8,43,20,6,1,7,39,0.5064935064935064,480,134,346,1
Luka Doncic,DAL,285,10230,914,119.09906433876723,115.15180862912209,8094,0.22554002541296062,0.3431372549019608,0.2738225629791895,0.1940700808625337,150,136,14,66,66,4,3,11,78,0.52,363,122,241,3
De'Aaron Fox,SAC,289,10144,83,117.79709049688267,118.2034333539398,6769,0.2383612662942272,0.36363636363636365,0.32459016393442625,0.2163355408388521,112,95,17,37,51,7,8,9,60,0.5357142857142857,431,225,206,2
Tobias Harris,DET,303,10142,993,116.9265470236344,112.42682146898214,4591,0.1798063623789765,0.3556701030927835,0.30028735632183906,0.11737089201877934,201,188,13,84,92,12,5,8,102,0.5074626865671642,260,96,164,4
Trae Young,ATL,290,10122,405,118.86181152274969,117.42881387893645,7054,0.22205663189269748,0.40093240093240096,0.33560864618885095,0.21652421652421652,42,37,5,16,19,2,1,4,28,0.6666666666666666,309,117,192,0
Jalen Brunson,NYK,315,10114,1194,119.81029002781088,114.59197441407225,6117,0.23728813559322035,0.35755813953488375,0.33638443935926776,0.22888283378746593,33,30,3,18,12,0,1,2,18,0.5454545454545454,247,77,170,0
Buddy Hield,GSW,339,10113,-151,116.1042798589267,117.49592560636565,4540,0.24219210371243372,0.35271317829457366,0.32608695652173914,0.17801047120418848,128,120,8,64,55,1,2,6,71,0.5546875,317,136,181,1
RJ Barrett,TOR,294,9958,-299,113.83057912758673,115.23431688569303,5263,0.2275189599133261,0.38514442916093533,0.36133333333333334,0.2222222222222222,79,75,4,47,26,2,1,3,51,0.6455696202531646,174,57,117,1
Rudy Gobert,MIN,306,9837,1640,116.79701296735456,108.3417287930687,3126,0,0.36904761904761907,0.26200873362445415,0.1875,618,602,16,307,280,15,8,8,371,0.6003236245954693,209,48,161,29
Kentavious Caldwell-Pope,ORL,321,9769,1051,117.8596632725073,112.6185192656849,3200,0.202576112,0.3802083333333333,0.3163841807909605,0.22627737226277372,143,136,7,47,85,4,4,3,70,0.48951048951048953,397,119,278,0
Devin Booker,PHX,279,9748,1318,119.95596477181745,113.91934023936437,6864,0.21435142594296228,0.3860759493670886,0.32073011734028684,0.21746031746031746,97,92,5,51,38,3,1,4,50,0.5154639175257731,268,73,195,4
Bam Adebayo,MIA,288,9747,556,114.10362266487769,111.50483679064715,4797,0.1267605633802817,0.36065573770491804,0.20892494929006086,0.11003236245954692,254,247,7,100,128,19,5,2,142,0.5590551181102362,358,99,259,47
Terry Rozier,MIA,286,9675,-601,113.1578947368421,116.28153380423815,5074,0.21940298507462686,0.39325842696629215,0.31608133086876156,0.19622641509433963,96,92,4,51,40,1,1,3,46,0.4791666666666667,328,114,214,0
Jaylen Brown,BOS,280,9653,1353,118.3023067583974,111.71787851130718,6273,0.20563847429519072,0.4025695931477516,0.30869565217391304,0.16809116809116809,120,118,2,64,48,6,0,2,66,0.55,321,141,180,2
Royce O'Neale,PHX,326,9604,907,117.31243576567319,112.17889673523693,2291,0.25274725274725274,0.4358974358974359,0.448,0.25,171,166,5,79,78,9,0,5,92,0.5380116959064327,289,79,210,0
Giannis Antetokounmpo,MIL,285,9544,1505,119.91110667199361,112.90824261275272,7673,0.22137404580152673,0.37037037037037035,0.31457431457431456,0.15718157181571815,322,317,5,189,115,13,2,3,215,0.6677018633540373,294,127,167,29
James Harden,LAC,263,9447,895,119.61374069969924,114.95169209651021,5038,0.21398124467178176,0.3649025069637883,0.41030927835051545,0.33,173,154,19,68,81,5,5,14,84,0.48554913294797686,321,115,206,0
Tyrese Haliburton,IND,285,9431,-309,116.7886923,118.86137350012766,4581,0.22400756143667297,0.33760683760683763,0.30917874396135264,0.23222748815165878,165,114,51,45,54,15,14,37,104,0.6303030303030303,417,74,343,1
Darius Garland,CLE,272,9296,820,115.9092125689203,112.36785329018339,4989,0.22614107883817428,0.3811881188118812,0.3089430894308943,0.25925925925925924,35,33,2,17,13,3,0,2,17,0.4857142857142857,337,99,238,0
Stephen Curry,GSW,275,9275,1346,117.98901434238633,112.1586943132827,7070,0.24512987012987014,0.36363636363636365,0.37971698113207547,0.22661870503597123,87,83,4,20,54,9,0,4,41,0.47126436781609193,291,124,167,0
Russell Westbrook,DEN,306,9247,-324,113.68114758282711,115.20575187394829,4559,0.1820689655172414,0.3236641221374046,0.256993007,0.19599109131403117,113,107,6,50,54,3,3,3,59,0.5221238938053098,348,138,210,2
Jrue Holiday,BOS,283,9216,1809,120.65092466826874,111.35757258697357,4283,0.223915592,0.3151515151515151,0.3172268907563025,0.22448979591836735,152,136,16,51,73,12,1,15,77,0.506578947,360,170,190,3
Coby White,CHI,306,9193,-85,115.14909478168263,115.58939410073475,4081,0.22461273666092943,0.4173669467787115,0.330188679,0.21808510638297873,55,55,0,32,22,1,0,0,28,0.509090909,199,62,137,2
Donovan Mitchell,CLE,267,9177,1396,118.53023156089193,111.63379674533893,6555,0.2134228187919463,0.3937947494033413,0.35423728813559324,0.19337016574585636,92,91,1,52,36,3,0,1,42,0.45652173913043476,388,101,287,4
Josh Hart,NYK,281,9159,580,117.92432314885289,114.60912052117264,2741,0.2508532423208191,0.40350877192982454,0.41743119266055045,0.3064516129032258,77,71,6,50,21,0,2,4,49,0.6363636363636364,294,110,184,1
Jarrett Allen,CLE,289,9080,583,115.9114626242654,112.35764345159878,3399,0.14705882352941177,0.2850678733031674,0.17902813299232737,0.234375,352,349,3,284,62,3,2,1,217,0.6164772727272727,206,48,158,8
Keldon Johnson,SAS,299,9045,-1046,112.3192258613356,117.86188932007867,4324,0.18805309734513273,0.46226415094339623,0.3380281690140845,0.17333333333333334,74,70,4,43,27,0,0,4,47,0.6351351351351351,213,78,135,4
Dennis Schroder,BKN,293,9011,62,114.17085976810326,114.0625856305146,3843,0.23481781376518218,0.3333333333333333,0.2883817427385892,0.1875,52,50,2,24,23,3,1,1,28,0.5384615384615384,261,100,161,0
Kyle Kuzma,WAS,280,9008,-983,110.84577650800496,116.05084563180007,4637,0.15841584158415842,0.3366013071895425,0.28290468986384265,0.16393442622950818,179,171,8,82,83,6,2,6,89,0.4972067039106145,155,38,117,22
Dorian Finney-Smith,BKN,290,8968,388,117.02980356739671,114.54873036428128,2347,0.19109663409337677,0.37435897435897436,0.33035714285714285,0.16666666666666666,146,145,1,109,35,1,0,1,80,0.547945205,266,91,175,4
CJ McCollum,NOP,262,8954,316,117.06688596491227,115.74053697183099,5161,0.2360549717057397,0.3485915492957746,0.2996632996632997,0.20393120393120392,128,125,3,54,67,4,0,3,72,0.5625,262,99,163,0
P.J. Washington,DAL,294,8941,-235,113.8789843327931,115.33549783549783,3393,0.22949117341640707,0.3667711598746082,0.3548387096774194,0.18309859154929578,301,290,11,192,96,2,6,5,166,0.5514950166112956,289,115,174,22
Gary Trent Jr.,MIL,286,8908,-162,115.52743548654473,116.71282960336804,4113,0.26571668063704945,0.4381443298969072,0.3763157894736842,0.21890547263681592,54,54,0,21,30,3,0,0,29,0.5370370370370371,378,189,189,2
Shai Gilgeous-Alexander,OKC,257,8876,568,116.1226242886288,113.45076492135317,6779,0.215962441,0.32786885245901637,0.2319526627218935,0.1873198847262248,224,190,34,86,93,11,11,23,133,0.59375,399,188,211,0
Damian Lillard,MIL,247,8863,639,119.93344607495499,116.93875314999453,6348,0.2192866578599736,0.3488372093023256,0.3136645962732919,0.20588235294117646,68,65,3,25,36,4,0,3,34,0.5,220,103,117,0
LeBron James,LAL,250,8852,475,116.75412703618673,114.1326921,6213,0.2101593625498008,0.40081799591002043,0.3117154811715481,0.1978021978021978,167,164,3,91,68,5,0,3,100,0.5988023952095808,276,85,191,19
Tyrese Maxey,PHI,282,8814,663,117.05606154890535,113.76235374304214,4926,0.21177802944507362,0.34557235421166305,0.30918727915194344,0.2,91,82,9,30,45,7,0,9,50,0.5494505494505495,231,83,148,1
Saddiq Bey,ATL,292,8804,-878,112.4724548259145,117.43230574091434,3480,0.2273519163763066,0.44072948328267475,0.3166144200626959,0.23015873015873015,54,48,6,27,20,1,1,5,27,0.5,246,91,155,6
Derrick White,BOS,289,8759,1598,119.56387689892932,110.63078216989067,3673,0.2131455399061033,0.40384615384615385,0.29427792915531337,0.21505376344086022,281,255,26,109,134,12,6,20,165,0.5871886120996441,241,109,132,5
Zach LaVine,CHI,249,8735,-121,114.40914158305462,115.21205357142858,5694,0.18282548476454294,0.3600867678958785,0.27075812274368233,0.19164619164619165,82,74,8,49,20,5,0,8,48,0.5853658536585366,194,55,139,0
D'Angelo Russell,LAL,277,8690,349,116.69051287695356,115.18833535844472,4590,0.21702838063439064,0.33816425120772947,0.2906178489702517,0.17627118644067796,108,98,10,40,50,8,0,10,54,0.5,267,76,191,0
Jordan Poole,WAS,307,8681,-459,111.81972324016846,114.93374388299334,5101,0.20773638968481375,0.34256055363321797,0.2796610169491525,0.1581196581196581,86,81,5,30,50,1,2,3,55,0.6395348837209303,267,107,160,1
Kevin Huerter,SAC,304,8641,538,118.63633804402905,116.09091423079097,3385,0.2136986301369863,0.3333333333333333,0.3018867924528302,0.16666666666666666,103,97,6,42,50,5,2,4,61,0.5922330097087378,284,73,211,2
Jaden McDaniels,MIN,307,8526,104,114.02857142857142,113.22724161533196,2658,0.23134328358208955,0.34418604651162793,0.32432432432432434,0.225,249,232,17,139,85,8,3,14,137,0.5502008032128514,250,98,152,14
Chris Paul,SAS,276,8451,1013,117.26190476190476,112.06977563726066,3435,0.23778501628664495,0.38,0.30446194225721784,0.20935412026726058,72,70,2,28,38,4,1,1,39,0.5416666666666666,415,194,221,0
Aaron Gordon,DEN,277,8438,1397,120.77241218617115,113.02314706570024,3407,0.15991902834008098,0.5073170731707317,0.33557046979865773,0.21212121212121213,177,168,9,99,61,8,0,9,114,0.6440677966101694,193,57,136,18
Jimmy Butler,MIA,250,8402,766,116.5619953346492,112.13464302827023,4789,0.2,0.38687782805429866,0.31378299120234604,0.18867924528301888,89,65,24,33,29,3,15,9,50,0.5617977528089888,419,166,253,1
Luguentz Dort,OKC,279,8400,-5,113.83744855967078,113.65166295852588,3333,0.20404234841193455,0.4077669902912621,0.28044280442804426,0.16455696202531644,127,120,7,55,57,8,1,6,76,0.5984251968503937,264,115,149,5
Andrew Wiggins,GSW,272,8377,396,114.46461397058823,111.94543161756276,3949,0.17262638717632553,0.3854166666666667,0.3045186640471513,0.16828478964401294,204,188,16,57,117,14,4,12,125,0.6127450980392157,249,93,156,3
Jonas Valanciunas,WAS,319,8336,190,115.4653150232805,114.71057766215337,3579,0.1858108108108108,0.4437367303609342,0.19796954314720813,0.14814814814814814,256,256,0,137,115,4,0,0,174,0.6796875,136,36,100,8
Malik Beasley,DET,301,8332,139,115.5468705097994,114.86020020711081,3546,0.25700280112044815,0.4863013698630137,0.3373015873015873,0.16176470588235295,38,35,3,16,17,2,2,1,20,0.5263157894736842,216,52,164,3
Tyler Herro,MIA,251,8293,372,114.60477996508337,112.6705300012073,4516,0.23568075117370893,0.37142857142857144,0.2903225806451613,0.24522292993630573,46,39,7,19,15,5,4,3,25,0.5434782608695652,177,48,129,6
Mike Conley,MIN,285,8262,1301,118.00791556728232,110.70417444732246,3386,0.24074074074074073,0.42857142857142855,0.35467980295566504,0.2727272727272727,65,60,5,25,29,6,2,3,32,0.49230769230769234,357,162,195,0
Ivica Zubac,LAC,317,8236,276,115.08498155204741,113.6148812409113,2602,0,0.35333333333333333,0.24375,0.16666666666666666,346,339,7,219,116,4,3,4,217,0.6271676300578035,124,24,100,7
Franz Wagner,ORL,256,8204,153,112.27944255039178,111.42429682824657,4260,0.2392807745504841,0.3921971252566735,0.33447098976109213,0.22077922077922077,91,86,5,37,44,5,3,2,51,0.5604395604395604,264,98,166,1
Brandon Ingram,NOP,243,8198,309,116.18858620482291,114.54392095433185,5070,0.24669603524229075,0.4224137931034483,0.2838709677419355,0.24962406015037594,132,126,6,70,52,4,3,3,76,0.5757575757575758,174,49,125,7
John Collins,UTA,278,8176,-156,116.75768728481538,117.70468443863919,3659,0.21294718909710392,0.3782051282051282,0.31662870159453305,0.1487603305785124,271,267,4,161,103,3,1,3,167,0.6162361623616236,173,68,105,24
Deandre Ayton,POR,266,8160,162,114.84639574262215,114.35078343252763,3528,0.19402985074626866,0.4212218649517685,0.19906687402799378,0.13026819923371646,229,224,5,103,116,5,1,4,133,0.5807860262008734,189,43,146,12
Deni Avdija,POR,311,8156,-657,112.58782547086261,115.85809937742277,2828,0.2052877138413686,0.40955631399317405,0.29464285714285715,0.14285714285714285,144,144,0,70,72,2,0,0,74,0.5138888888888888,240,73,167,5
Isaac Okoro,CLE,300,8132,-74,114.01148077279181,113.15516504972848,2232,0.2509727626459144,0.40181268882175225,0.35664335664335667,0.23529411764705882,119,113,6,59,45,9,1,5,54,0.453781513,246,61,185,2
Kevin Durant,PHX,225,8131,1135,119.69353684712617,112.89265065267925,5870,0.2223816355810617,0.3533834586466165,0.27844311377245506,0.21244635193133046,274,245,29,119,120,6,9,20,162,0.5912408759124088,183,62,121,4
Jalen Green,HOU,249,8124,-877,112.44944087556507,118.23561054330285,4532,0.273286467,0.3804347826086957,0.3829787234042553,0.23745819397993312,71,61,10,31,26,4,3,7,45,0.6338028169014085,195,70,125,8
Clint Capela,ATL,300,8121,353,117.86012650674304,115.34756496402451,2578,0,0.44490934449093444,0.36942675159235666,0.125,430,423,7,303,117,3,0,7,280,0.6511627906976745,203,73,130,41
Jerami Grant,POR,240,8119,-918,110.86771844660194,116.56542339934394,4416,0.2222222222222222,0.3604060913705584,0.32662192393736017,0.20512820512820512,218,193,25,124,53,16,5,20,128,0.5871559633027523,196,85,111,12
Tim Hardaway Jr.,DET,284,8115,179,117.01257477719449,116.21075821553148,3738,0.2,0.32515337423312884,0.26436781609195403,0.17164179104477612,35,31,4,18,13,0,0,4,20,0.5714285714285714,166,57,109,0
OG Anunoby,NYK,231,8089,937,117.27613545571876,111.59972938065071,3343,0.25492610837438423,0.41284403669724773,0.35018050541516244,0.20610687022900764,167,140,27,64,60,16,15,12,99,0.592814371,369,111,258,1
Dillon Brooks,HOU,268,8066,705,115.88291746641075,111.60741051621801,3613,0.2537313432835821,0.40066225165562913,0.3418803418803419,0.24358974358974358,67,64,3,39,23,2,1,2,32,0.47761194029850745,257,94,163,2
Kyrie Irving,DAL,223,8020,967,120.93913254768557,115.40851763845733,5465,0.188911704,0.3501683501683502,0.28739495798319326,0.2175226586102719,132,127,5,44,80,3,1,4,79,0.5984848484848485,285,141,144,3
Grayson Allen,PHX,282,8002,706,117.47232137455381,113.41374712086314,2935,0.21451787648970747,0.2792207792207792,0.3333333333333333,0.32142857142857145,91,90,1,53,35,2,1,0,50,0.5494505494505495,237,90,147,5
Anthony Davis,LAL,231,7984,332,114.90245664739884,113.14185723767575,4738,0.1524822695035461,0.3856041131105398,0.22302158273381295,0.1572769953051643,487,454,33,224,217,13,8,25,311,0.6386036960985626,273,74,199,10
Kelly Oubre Jr.,PHI,269,7981,-595,111.82060283258686,114.9002831837079,3774,0.19433962264150945,0.36855036855036855,0.33853006681514475,0.189873418,149,135,14,81,50,4,6,8,71,0.47651006711409394,307,154,153,5
Jordan Clarkson,UTA,276,7967,430,117.25869671729544,114.77279695836144,4455,0.271889401,0.3442622950819672,0.3706395348837209,0.40217391304347827,46,45,1,25,19,1,0,1,28,0.6086956521739131,206,78,128,1
Caris LeVert,CLE,266,7926,426,115.81130440165913,113.38460584258513,3699,0.22685788787483702,0.3956043956043956,0.28717948717948716,0.184,119,114,5,53,59,2,3,2,67,0.5630252100840336,282,94,188,1
Lauri Markkanen,UTA,251,7859,205,116.7824792157836,115.55362462760675,4240,0.24737344794651384,0.4711864406779661,0.3342541436464088,0.26881720430107525,111,108,3,51,57,0,1,2,62,0.5585585585585585,175,39,136,6
Karl-Anthony Towns,NYK,236,7856,786,118.05332674978396,113.74263565891472,4770,0.17420212765957446,0.39461883408071746,0.27655310621242485,0.098039216,217,211,6,118,90,3,3,3,123,0.5668202764976958,190,76,114,17
Scottie Barnes,TOR,224,7831,63,114.93341788205454,114.32369137287169,3197,0.23754789272030652,0.4477124183006536,0.36460176991150445,0.18660287081339713,214,186,28,103,82,1,7,21,128,0.5981308411214953,256,85,171,19
Terance Mann,LAC,327,7808,107,114.97864746000383,113.60871768879878,2522,0.2088888888888889,0.4268292682926829,0.3107569721115538,0.1926605504587156,76,70,6,39,28,3,0,6,56,0.7368421052631579,191,72,119,3
Norman Powell,LAC,268,7807,-35,115.60341071761998,116.14654849581825,4265,0.19685990338164253,0.36079545454545453,0.3390804597701149,0.20270270270270271,82,70,12,25,41,4,4,8,50,0.6097560975609756,237,92,145,3
Jakob Poeltl,TOR,282,7793,36,115.59937402190923,115.33070521243977,2518,0,0.33153638814016173,0.2821576763485477,0.36363636363636365,432,430,2,284,145,1,1,1,269,0.6226851851851852,219,65,154,5
Bobby Portis,MIL,312,7751,421,117.05063370169196,114.5294338207724,3437,0.1872,0.4290322580645161,0.21095334685598377,0.16785714285714284,140,138,2,60,74,4,0,2,80,0.5714285714285714,214,67,147,6
Brook Lopez,MIL,263,7739,1011,118.15318097591106,112.15103683070257,2986,0.23056994818652848,0.32989690721649484,0.30566037735849055,0.095238095,551,548,3,309,233,6,0,3,358,0.6497277676950998,154,57,97,14
Bojan Bogdanovic,NYK,257,7718,-37,116.0129474,116.27729812087354,4160,0.2564366632337796,0.36398467432950193,0.29273504273504275,0.2846715328467153,18,18,0,7,9,2,0,0,10,0.5555555555555556,143,28,115,1
Paul George,PHI,227,7706,1121,118.19762947693893,111.39273244536403,4819,0.18471953578336556,0.47547169811320755,0.3315508021390374,0.1714922048997773,98,92,6,47,42,3,2,4,60,0.6122448979591837,347,165,182,4
Draymond Green,GSW,258,7697,1048,116.95884849603249,110.70988415085039,1880,0.17901234567901234,0.3333333333333333,0.33624454148471616,0.16666666666666666,231,191,40,79,109,3,19,21,155,0.670995671,316,126,190,1
Miles Bridges,CHA,226,7681,-570,113.39621439041488,116.79068879984736,3663,0.21235521235521235,0.34285714285714286,0.32298136645962733,0.13821138211382114,157,147,10,97,46,4,4,6,93,0.5923566878980892,190,56,134,13
Grant Williams,CHA,311,7666,70,114.84183344092963,113.93389917695472,2168,0.2260596546310832,0.3821138211382114,0.32275132275132273,0.17647058823529413,164,132,32,66,50,16,9,23,94,0.573170732,173,52,121,5
Donte DiVincenzo,MIN,284,7653,540,117.28278041074249,114.0506329113924,2865,0.24150596877869604,0.33195020746887965,0.41333333333333333,0.22,75,71,4,43,25,3,1,3,42,0.56,353,105,248,3
Joel Embiid,PHI,229,7634,1449,119.22454527801152,110.1948051948052,6416,0.10961968680089486,0.4507042253521127,0.22739018087855298,0.14395393474088292,352,347,5,222,116,9,4,1,214,0.6079545454545454,241,68,173,19
Desmond Bane,MEM,261,7550,603,115.54946106256777,112.24764468371467,4010,0.2623814541622761,0.3745704467353952,0.38461538461538464,0.20588235294117646,97,81,16,37,40,4,3,13,60,0.6185567010309279,249,99,150,0
Bradley Beal,PHX,218,7527,0,115.96600785424579,115.95107821049244,4745,0.20910384068278806,0.38198757763975155,0.3287904599659284,0.2741514360313316,108,100,8,36,59,5,2,6,62,0.5740740740740741,219,82,137,2
Kyle Lowry,PHI,240,7492,205,113.77344733876848,112.67605633802816,2591,0.1702127659574468,0.42735042735042733,0.3067484662576687,0.20754716981132076,78,76,2,32,40,4,0,2,36,0.46153846153846156,245,117,128,0
Reggie Jackson,PHI,302,7473,167,113.81277781463545,112.82459985388856,3336,0.1873536299765808,0.38515901060070673,0.3862559241706161,0.2,44,44,0,26,18,0,0,0,23,0.5227272727272727,193,61,132,0
Immanuel Quickley,TOR,294,7442,701,115.41663868931712,111.09763493026077,3658,0.22517911975435004,0.4444444444444444,0.3481781376518219,0.2918918918918919,39,31,8,17,13,1,3,5,24,0.6153846153846154,216,64,152,0
Kyle Anderson,GSW,308,7432,363,113.77916829618043,110.92147955872811,2313,0.2514450867052023,0.32710280373831774,0.2766884531590414,0.23157894736842105,222,210,12,113,88,9,5,7,139,0.6261261261261262,328,141,187,2
Spencer Dinwiddie,DAL,247,7392,107,115.7752930082177,115.07006197790353,3057,0.21401752190237797,0.3333333333333333,0.30140845070422534,0.21,66,59,7,22,29,8,1,6,35,0.5303030303030303,177,44,133,0
Tyus Jones,PHX,312,7386,-249,113.52474990255944,115.32205595315551,2714,0.22906793048973143,0.39552238805970147,0.3122448979591837,0.2,34,31,3,8,21,2,0,3,16,0.47058823529411764,311,91,220,0
Duncan Robinson,MIA,282,7379,300,113.45526244220831,112.15522551502292,2945,0.2188006482982172,0.3493975903614458,0.3364485981308411,0.076923077,53,46,7,17,27,2,2,5,26,0.49056603773584906,156,51,105,2
Bruce Brown,TOR,284,7370,-172,116.84602099109871,117.10179324894514,2529,0.23770491803278687,0.37545126353790614,0.3566084788029925,0.1774193548387097,148,119,29,40,68,11,8,21,79,0.5337837837837838,281,104,177,1
Myles Turner,IND,251,7326,105,116.1832869818567,115.78702781650402,3378,0.17872968980797638,0.29389312977099236,0.21621621621621623,0.11594202898550725,608,597,11,398,191,8,5,6,351,0.5773026315789473,162,56,106,41
Michael Porter Jr.,DEN,235,7325,1392,122.2617689,113.79263670817542,3578,0.1893362350380849,0.4117647058823529,0.319047619,0.17842323651452283,147,139,8,75,55,9,3,5,85,0.5782312925170068,148,40,108,20
Bogdan Bogdanovic,ATL,250,7317,499,118.56458693627776,115.6300053390283,3509,0.24119241192411925,0.5138121546961326,0.3487544483985765,0.23780487804878048,74,65,9,33,26,6,5,4,38,0.5135135135135135,266,78,188,0
Evan Mobley,CLE,222,7314,680,115.28753666689406,110.74696162774818,2966,0.20187793427230047,0.3785488958990536,0.26579925650557623,0.22321428571428573,343,337,6,219,113,5,0,6,228,0.6647230320699709,187,66,121,17
Anfernee Simons,POR,250,7174,-598,113.76355973191461,118.24670824670824,3906,0.22859744990892533,0.3217391304347826,0.3465045592705167,0.2558139534883721,35,33,2,16,16,1,0,2,19,0.5428571428571428,130,41,89,5
Ayo Dosunmu,CHI,258,7167,-557,112.45229007633588,116.19320117174195,2409,0.2268041237113402,0.3993055555555556,0.3157894736842105,0.2,103,101,2,57,38,6,1,1,55,0.5339805825242718,207,69,138,7
Malik Monk,SAC,285,7120,225,116.1251343,115.69424679812971,3657,0.23173277661795408,0.36395759717314485,0.3443708609271523,0.24166666666666667,100,82,18,39,40,3,2,16,59,0.59,188,53,135,3
Nicolas Batum,LAC,289,6985,623,116.05721130134573,112.03081925496572,1728,0.16129032258064516,0.4520547945205479,0.42857142857142855,0.12903225806451613,172,149,23,95,46,8,6,17,109,0.6337209302325582,237,66,171,8
Al Horford,BOS,243,6960,1115,118.32137019401605,110.84629656058229,2177,0.18501529051987767,0.35537190082644626,0.24855491329479767,0.2112676056338028,258,240,18,114,116,10,8,10,166,0.6434108527131783,156,36,120,12
Cole Anthony,ORL,276,6952,-434,111.08586037923443,114.21669626998224,3229,0.19089574155653452,0.4085603112840467,0.32150313152400833,0.25,106,100,6,48,46,6,2,4,53,0.5,187,86,101,1
Jaren Jackson Jr.,MEM,241,6941,471,114.71363195118569,111.73444560305875,4023,0.24875,0.3838383838383838,0.34915773353751917,0.3,534,520,14,331,184,5,9,5,295,0.552434457,262,93,169,31
Herbert Jones,NOP,227,6826,439,116.57382623164293,113.12788683602771,2059,0.23785166240409208,0.3902439024390244,0.39325842696629215,0.25,168,126,42,65,57,4,15,27,97,0.5773809523809523,351,104,247,2
Kristaps Porzingis,BOS,221,6760,559,118.25720104742508,114.97729603046727,4073,0.17408906882591094,0.413953488,0.2383073496659243,0.1411764705882353,360,349,11,185,152,12,0,11,230,0.6388888888888888,162,34,128,11
Marcus Smart,MEM,215,6759,827,116.93930262591476,110.92629767708632,2393,0.2210796915167095,0.3157894736842105,0.2744360902255639,0.2153846153846154,75,74,1,35,38,1,1,0,44,0.5866666666666667,347,144,203,1
Josh Giddey,CHI,235,6758,-116,113.83950704724131,114.92155888407751,2835,0.20943396226415095,0.3730964467005076,0.31902985074626866,0.18518518518518517,106,101,5,45,56,0,4,1,56,0.5283018867924528,180,74,106,1
Georges Niang,CLE,333,6749,677,116.58875091307523,112.5230066995509,2559,0.22459893048128343,0.3853211009174312,0.33695652173913043,0.17391304347826086,58,58,0,27,30,1,0,0,26,0.4482758620689655,124,57,67,0
Khris Middleton,MIL,224,6741,867,118.77459246767847,113.4720158494304,3691,0.20680272108843537,0.38095238095238093,0.33737864077669905,0.20738636363636365,48,46,2,18,26,2,1,1,28,0.5833333333333334,226,72,154,2
Cameron Johnson,BKN,249,6721,435,115.08823529411765,112.42704100480236,2914,0.2100558659217877,0.31690140845070425,0.3615819209039548,0.15384615384615385,72,69,3,37,32,0,1,2,34,0.4722222222222222,213,88,125,2
Isaiah Stewart,DET,260,6652,-813,108.99830220713073,114.72862508284852,1784,0.18484848484848485,0.4420485175202156,0.3488372093023256,0.0625,269,265,4,144,120,1,2,2,180,0.6691449814126395,111,35,76,25
Wendell Carter Jr.,ORL,241,6651,-282,110.14076203110031,112.26039516366855,2486,0.1759465478841871,0.3459915611814346,0.23371647509578544,0.11904761904761904,153,152,1,91,60,1,0,1,99,0.6470588235294118,148,42,106,15
Rui Hachimura,LAL,249,6649,-140,113.9518107055259,114.76307071870949,2859,0.21889400921658986,0.3160377358490566,0.27522935779816515,0.2204724409448819,79,79,0,52,26,1,0,0,61,0.7721518987341772,146,42,104,18
Pat Connaughton,MIL,286,6640,315,116.4122965641953,114.39860798955992,1865,0.2483912483912484,0.3157894736842105,0.38596491228070173,0.35714285714285715,73,38,35,19,17,2,6,29,50,0.684931507,188,53,135,0
Devin Vassell,SAS,248,6635,-693,111.17761592269417,116.09137421632917,3131,0.24708926261319533,0.43137254901960786,0.28523489932885904,0.2108843537414966,103,99,4,61,35,3,1,3,60,0.5825242718446602,245,71,174,7
Reggie Bullock Jr.,HOU,255,6633,236,114.74451446359426,112.92697737968726,1725,0.22091503267973855,0.2549019607843137,0.2727272727272727,0.18333333333333332,43,36,7,19,15,2,3,4,16,0.37209302325581395,159,51,108,0
Caleb Martin,PHI,268,6607,-15,112.9618320610687,112.33884422872742,2008,0.2265625,0.4,0.29775280898876405,0.25984251968503935,111,84,27,58,24,2,14,13,63,0.5675675675675675,232,60,172,4
Max Strus,CLE,257,6605,240,114.63580153822953,113.15033272837265,2418,0.23728813559322035,0.37037037037037035,0.3372093023255814,0.22727272727272727,59,47,12,25,20,2,3,9,30,0.5084745762711864,145,40,105,0
Ja Morant,MEM,204,6602,684,117.14988070276914,112.44022605419504,4469,0.22504230118443316,0.4164989939637827,0.37032085561497324,0.30927835051546393,61,58,3,40,18,0,1,2,35,0.5737704918032787,210,64,146,15
Eric Gordon,PHI,237,6580,-339,113.62902041415772,116.31482162559766,2689,0.24408468244084683,0.36082474226804123,0.2889908256880734,0.2857142857142857,91,78,13,25,41,12,2,11,48,0.5274725274725275,161,70,91,0
Austin Reaves,LAL,226,6531,187,116.11649061032864,115.1417004048583,2688,0.21201413427561838,0.35714285714285715,0.3113207547169811,0.18681318681318682,68,61,7,24,31,6,1,6,38,0.5588235294117647,148,44,104,0
Corey Kispert,WAS,250,6487,-677,113.32438078185616,118.85393258426966,2494,0.23243933588761176,0.31092436974789917,0.2867647058823529,0.21212121212121213,50,49,1,33,16,0,0,1,28,0.56,120,40,80,0
LaMelo Ball,CHA,202,6484,-291,114.30455811226733,117.05466332694857,3823,0.20118929633300298,0.35609756097560974,0.345679012,0.21476510067114093,67,63,4,31,30,2,3,1,36,0.5373134328358209,306,105,201,0
Kelly Olynyk,TOR,257,6476,-417,114.52297609294703,118.00657501494321,2532,0.163003663,0.3891625615763547,0.3333333333333333,0.2727272727272727,128,120,8,75,42,3,5,3,66,0.515625,246,95,151,2
De'Andre Hunter,ATL,214,6450,46,117.1356260235224,116.9150521609538,2949,0.23411371237458195,0.3627450980392157,0.32326283987915405,0.15346534653465346,68,61,7,27,28,6,2,5,36,0.5294117647058824,142,45,97,1
Alperen Sengun,HOU,234,6449,-375,113.81708238851095,117.5847619047619,2964,0.1722488038277512,0.38716814159292035,0.2813102119460501,0.1506849315068493,210,206,4,120,85,1,1,3,121,0.5761904761904761,232,84,148,15
Mason Plumlee,PHX,276,6416,-385,113.63670838073568,116.57437609041946,1793,0.21428571428571427,0.3821428571428571,0.29120879120879123,0.16666666666666666,184,176,8,102,72,2,3,5,101,0.5489130434782609,172,68,104,13
Nic Claxton,BKN,244,6409,-56,114.77716966379984,113.94108095569473,2072,0.18181818181818182,0.2764505119453925,0.2857142857142857,0,449,436,13,250,177,9,5,8,269,0.5991091314031181,171,53,118,46
Kevon Looney,GSW,320,6394,545,117.37898284313725,112.12259141253224,1221,0.071428571,0.453125,0.3701657458563536,0.2153846153846154,159,157,2,54,100,3,1,1,99,0.6226415094339622,169,79,90,0
Naz Reid,MIN,319,6345,-213,110.76771205102894,112.17219948461423,3027,0.19818456883509833,0.3424242424242424,0.27134146341463417,0,292,278,14,170,107,1,8,6,174,0.5958904109589042,198,53,145,13
Patrick Williams,CHI,228,6336,-582,112.13716231906494,116.02248229134587,1966,0.23076923076923078,0.37142857142857144,0.3170731707317073,0.12738853503184713,166,159,7,94,58,7,1,6,102,0.6144578313253012,200,68,132,10
Jusuf Nurkic,PHX,237,6314,518,117.22295361263843,113.59857020747533,2379,0.21304347826086956,0.40040241448692154,0.2978723404255319,0.052631579,207,207,0,135,68,4,0,0,127,0.6135265700483091,239,86,153,6
Jamal Murray,DEN,189,6311,1011,122.2827804107425,114.49596455135307,3603,0.21375186846038863,0.43842364532019706,0.36056338028169016,0.22905027932960895,78,67,11,28,34,5,4,7,39,0.5,210,56,154,1
Collin Sexton,UTA,220,6293,-631,113.85840160766735,118.71715610510046,3762,0.2440944881889764,0.403125,0.36510791366906475,0.22784810126582278,37,36,1,12,24,0,0,1,22,0.5945945945945946,176,63,113,0
Alex Caruso,OKC,252,6276,488,113.09205350118017,109.33858267716535,1682,0.23157894736842105,0.3225806451612903,0.3360655737704918,0.24489795918367346,156,147,9,76,66,5,0,9,71,0.4551282051282051,381,131,250,1
Malcolm Brogdon,WAS,207,6215,-38,113.24628333202234,113.88560157790927,3314,0.215748031,0.3385012919896641,0.379182156,0.2304147465437788,58,48,10,25,20,3,3,7,37,0.6379310344827587,155,51,104,0
Josh Richardson,MIA,240,6176,-215,113.55891528677705,114.89276887506975,2254,0.21677215189873417,0.3508771929824561,0.32217573221757323,0.21468926553672316,88,80,8,43,34,3,0,8,55,0.625,218,76,142,2
Daniel Gafford,DAL,301,6139,-322,114.89982647105222,117.15319852073334,2118,0,0.3595505617977528,0.2760416666666667,0.10526315789473684,456,449,7,239,205,5,3,4,265,0.581140351,167,79,88,45
Jeff Green,HOU,284,6122,-95,115.18286814244465,115.02227880330999,2294,0.19718309859154928,0.3488372093023256,0.3080568720379147,0.24561403508771928,102,97,5,54,42,1,3,2,59,0.5784313725490197,100,29,71,3
KJ Martin,PHI,285,6122,-897,111.88408085912823,118.85452824234774,2047,0.2861356932153392,0.40594059405940597,0.3878787878787879,0,137,134,3,86,47,1,0,3,84,0.6131386861313869,134,43,91,10
Alec Burks,MIA,259,6087,46,113.36985853299534,112.9475232957332,2671,0.24142661179698216,0.3988439306358382,0.3238434163701068,0.2471264367816092,63,59,4,39,19,1,2,2,38,0.6031746031746031,188,54,134,0
Klay Thompson,DAL,198,6055,354,117.85798910038702,115.49988107508128,3370,0.25200356188780054,0.45569620253164556,0.2929936305732484,0.23157894736842105,88,84,4,26,46,12,0,4,52,0.5909090909090909,128,45,83,0
Christian Wood,LAL,226,6030,-548,112.22464294359719,116.53365578395808,3088,0.15780141843971632,0.34317343173431736,0.24187725631768953,0.092436975,218,208,10,127,77,4,2,8,140,0.6422018348623854,134,33,101,6
Taurean Prince,MIL,265,6005,-294,114.95185804090077,116.70625494853523,2113,0.1731748726655348,0.44,0.3390804597701149,0.19672131147540983,101,89,12,53,33,3,2,10,62,0.6138613861386139,180,54,126,2
De'Anthony Melton,GSW,246,5996,684,117.43789576229906,111.68557536466774,2252,0.22371967654986524,0.39303482587064675,0.3853658536585366,0.2619047619047619,129,120,9,65,52,3,2,7,72,0.5581395348837209,357,141,216,7
Seth Curry,CHA,249,5884,482,114.83773837403814,111.87299442661713,2349,0.24074074074074073,0.3333333333333333,0.2805755395683453,0.14869888475836432,39,31,8,14,14,3,0,8,20,0.5128205128205128,165,61,104,0
Gordon Hayward,OKC,194,5882,-243,112.53363777216016,114.57126539936364,2596,0.22276029055690072,0.37777777777777777,0.2421875,0.18433179723502305,61,58,3,32,24,2,0,3,45,0.7377049180327869,181,45,136,3
Keegan Murray,SAC,182,5881,320,119.0775334766077,116.73158200049723,2152,0.21306818181818182,0.3492063492063492,0.3488372093023256,0.18446601941747573,123,120,3,60,57,3,0,3,76,0.6178861788617886,158,50,108,0
Jae'Sean Tate,HOU,254,5867,-591,109.89643268124281,114.35943643512451,1905,0.20056497175141244,0.30033003300330036,0.35319148936170214,0.2222222222222222,99,89,10,39,44,6,6,4,60,0.6060606060606061,225,122,103,0
Kawhi Leonard,LAC,172,5850,1058,121.34907824313993,112.63839209674671,3806,0.24686192468619247,0.4088050314465409,0.2675736961451247,0.1761006289308176,108,99,9,51,46,2,4,5,69,0.6388888888888888,264,97,167,3
Nickeil Alexander-Walker,MIN,275,5830,204,113.22871846789842,111.05789429459709,2207,0.23242467718794835,0.32407407407407407,0.3403141361256545,0.20652173913043478,117,117,0,50,63,4,0,0,65,0.5555555555555556,209,80,129,0
Monte Morris,PHX,235,5821,553,118.37617714431153,114.02314499659633,2171,0.2311111111111111,0.35714285714285715,0.3440366972477064,0.19689119170984457,52,47,5,17,23,7,1,4,25,0.4807692307692308,159,55,104,0
Justin Holiday,DEN,249,5808,-325,112.10836865287128,114.51425729442971,1756,0.2170439414114514,0.3047619047619048,0.24444444444444444,0.13793103448275862,102,83,19,60,20,3,7,12,52,0.5098039215686274,186,68,118,1
Cedi Osman,SAS,274,5789,-505,111.12437132384281,115.04672897196261,2267,0.24015748031496062,0.36923076923076925,0.2875,0.2777777777777778,41,40,1,27,11,2,1,0,23,0.5609756097560976,176,76,100,3
Chris Boucher,TOR,289,5784,255,115.22001725625539,112.73775712195543,2132,0.1890909090909091,0.369281046,0.19424460431654678,0.2,291,231,60,117,109,5,28,32,172,0.5910652920962199,157,30,127,5
T.J. McConnell,IND,266,5746,-3,115.9498505479907,115.45710034716481,2352,0.17699115044247787,0.33203125,0.2827586206896552,0.20481927710843373,58,54,4,22,28,4,0,4,36,0.6206896551724138,343,98,245,0
P.J. Tucker,LAC,229,5743,162,115.82532751091703,113.82396385437484,898,0.17747440273037543,0.38636363636363635,0.2765957446808511,0.1111111111111111,57,57,0,27,27,3,0,0,35,0.6140350877192983,152,67,85,0
Luke Kennard,MEM,245,5742,252,114.8757497857755,113.13322439150254,2197,0.1996879875195008,0.3548387096774194,0.32,0.2462686567164179,24,23,1,10,12,1,1,0,9,0.375,125,41,84,0
Marcus Morris Sr.,CLE,225,5708,-86,115.04926323131922,116.12310920695987,2396,0.23623445825932504,0.40789473684210525,0.2846975088967972,0.2178988326848249,67,63,4,33,27,3,4,0,32,0.47761194029850745,119,37,82,0
Tre Jones,SAS,259,5679,-436,112.59384226064952,116.27161535217208,1965,0.22743682310469315,0.34649122807017546,0.3728813559322034,0.25925925925925924,27,24,3,15,8,1,0,3,12,0.4444444444444444,222,98,124,1
Matisse Thybulle,POR,267,5671,-62,112.66409942237003,111.72050440490585,1150,0.22811059907834103,0.3888888888888889,0.4153846153846154,0,223,140,83,33,73,34,27,56,119,0.5336322869955157,416,132,284,0
Jabari Smith Jr.,HOU,179,5594,-569,112.90379059791648,118.01928133216478,1938,0.24394463667820068,0.4032258064516129,0.28936170212765955,0.16770186335403728,157,153,4,81,69,3,1,3,112,0.7133757961783439,102,52,50,8
Patrick Beverley,MIL,235,5587,118,115.00883392226149,113.52516719464977,1496,0.21850393700787402,0.37037037037037035,0.35365853658536583,0.2,152,119,33,49,52,18,9,24,81,0.5328947368421053,202,108,94,1
Gary Harris,ORL,219,5574,-226,111.81490278877452,114.20499691003796,1744,0.24772313296903462,0.4065040650406504,0.36936936936936937,0.21739130434782608,51,50,1,18,30,2,0,1,31,0.6078431372549019,190,87,103,1
Isaiah Hartenstein,OKC,279,5536,810,118.14040728831726,111.04453586120552,1384,0.21153846153846154,0.3215686274509804,0.2182741116751269,0.25,275,270,5,171,98,1,1,4,171,0.6218181818181818,215,78,137,7
Derrick Jones Jr.,LAC,274,5519,154,115.90989712664064,113.76728617986436,1604,0.21774193548387097,0.41150442477876104,0.3854166666666667,0,181,164,17,97,62,5,6,11,94,0.5193370165745856,176,59,117,4
Jarred Vanderbilt,LAL,245,5481,53,116.1940100715611,114.84306505348063,1252,0.17391304347826086,0.36259541984732824,0.2805755395683453,0,118,114,4,62,52,0,1,3,60,0.5084745762711864,282,74,208,18
Killian Hayes,DET,210,5478,-1240,107.04300596563084,117.67524401064773,1576,0.18225419664268586,0.34579439252336447,0.27837837837837837,0.27906976744186046,93,90,3,34,52,4,0,3,53,0.5698924731182796,245,114,131,0
Devonte' Graham,SAS,227,5472,2,112.43150992544687,112.93087890272514,2133,0.24917309812568908,0.38823529411764707,0.3333333333333333,0.23015873015873015,36,36,0,10,24,2,0,0,18,0.5,173,52,121,0
Torrey Craig,CHI,266,5462,-669,113.05061559507523,117.60734539562516,1394,0.21961620469083157,0.4626865671641791,0.2916666666666667,0.13636363636363635,147,137,10,67,60,10,4,6,74,0.5034013605442177,155,51,104,2
Delon Wright,MIL,255,5451,3,113.37272727272727,113.17055459744032,1449,0.12709030100334448,0.3464052287581699,0.39351851851851855,0.12,83,78,5,33,37,8,1,4,46,0.5542168674698795,353,112,241,0
Robert Covington,PHI,218,5449,337,116.39816398163981,113.53884982873626,1406,0.1974169741697417,0.3130434782608696,0.36470588235294116,0.095238095,226,214,12,140,69,5,4,8,131,0.5796460176991151,281,114,167,5
Lonnie Walker IV,BKN,244,5442,-491,112.25542511561721,116.43580181140116,2539,0.19498607242339833,0.37209302325581395,0.273224044,0.1565217391304348,71,64,7,34,27,3,3,4,38,0.5352112676056338,135,35,100,3
Payton Pritchard,BOS,291,5414,677,118.26479808224231,112.55210745715608,2121,0.29871977240398295,0.37735849056603776,0.3790322580645161,0.1839080459770115,25,23,2,9,11,3,1,1,11,0.44,140,52,88,0
Paolo Banchero,ORL,157,5411,-185,113.20003618926988,115.02989672042037,3034,0.26605504587155965,0.36610169491525424,0.2942528735632184,0.23220973782771537,90,77,13,42,32,3,5,8,57,0.6333333333333333,134,47,87,3
Trey Murphy III,NOP,210,5400,188,114.57749661093537,113.17506342877854,2252,0.24016282225237448,0.4017857142857143,0.416,0.2894736842105263,86,81,5,42,35,4,2,3,58,0.6744186046511628,177,55,122,2
Onyeka Okongwu,ATL,256,5398,-6,116.76929941990183,116.84370257966616,1686,0.2125,0.34,0.23684210526315788,0.064516129,275,270,5,168,99,3,2,3,159,0.5781818181818181,152,47,105,5
Zion Williamson,NOP,166,5376,367,117.69299820466786,114.60431654676259,3583,0.19148936170212766,0.376,0.363855422,0.18181818181818182,109,103,6,64,38,1,1,5,66,0.6055045871559633,170,88,82,16
Talen Horton-Tucker,CHI,260,5345,-180,112.17879116901919,113.34594935568171,2360,0.21384928716904278,0.392097264,0.34394904458598724,0.26666666666666666,102,99,3,55,44,0,0,3,52,0.5098039215686274,212,110,102,2
Jalen Suggs,ORL,201,5329,-198,110.20930445114706,111.71269711056422,2209,0.2286634460547504,0.3333333333333333,0.37668161434977576,0.20909090909090908,116,110,6,60,47,3,3,3,72,0.6206896551724138,269,101,168,7
Cade Cunningham,DET,159,5316,-702,110.82866844085528,117.34618916437098,3046,0.21693121693121692,0.42249240121580545,0.2806236080178174,0.22869955156950672,88,85,3,58,24,3,2,1,48,0.5454545454545454,163,66,97,1
Davion Mitchell,TOR,251,5286,-348,112.16416527700575,114.36048113120926,1689,0.2336065573770492,0.33774834437086093,0.3227848101265823,0.2077922077922078,47,41,6,17,19,5,0,6,25,0.5319148936170213,138,58,80,1
Precious Achiuwa,NYK,265,5266,-107,113.03009904798539,113.53498612041734,1605,0.21951219512195122,0.4551282051282051,0.39194139194139194,0.24390243902439024,168,154,14,109,45,0,6,8,102,0.6071428571428571,135,50,85,5
Andre Drummond,PHI,284,5259,-125,113.38912133891213,113.76640543857992,1687,0.16666666666666666,0.40641711229946526,0.2823529411764706,0.3,200,189,11,113,70,6,2,9,121,0.605,285,103,182,19
Jaden Ivey,DET,175,5254,-1039,110.72252468395313,120.27675276752767,2560,0.21923076923076923,0.3979933110367893,0.32831325301204817,0.16666666666666666,68,65,3,32,33,0,1,2,31,0.45588235294117646,141,40,101,5
Jalen Williams,OKC,169,5230,498,117.01837365835911,112.4681702,2623,0.23030303030303031,0.3463203463203463,0.2169811320754717,0.1557377049180328,99,94,5,58,33,3,2,3,53,0.5353535353535354,232,108,124,4
Joe Ingles,MIN,233,5228,881,118.13597310422115,110.43445622595478,1594,0.23843416370106763,0.46296296296296297,0.44155844155844154,0.4,28,25,3,11,8,6,0,3,17,0.6071428571428571,144,47,97,0
Doug McDermott,SAC,264,5216,-431,113.42945230322815,118.79188469659414,2234,0.20552147239263804,0.35135135135135137,0.3356643356643357,0.14893617021276595,21,19,2,8,10,1,0,2,11,0.5238095238095238,64,21,43,1
Dwight Powell,DAL,297,5211,347,118.17216753522486,114.51395572666024,1466,0.17391304347826086,0.3717277486910995,0.23728813559322035,0.076923077,123,123,0,68,54,1,0,0,65,0.5284552845528455,154,59,95,7
Kevin Porter Jr.,LAC,168,5196,-861,110.42574900287542,118.63209738871852,2446,0.26978998384491115,0.328042328,0.28618421052631576,0.18309859154929578,54,50,4,25,24,1,0,4,25,0.46296296296296297,190,76,114,2
Aaron Nesmith,IND,249,5190,-44,117.06139128819541,117.21964782205745,1846,0.21834862385321102,0.37888198757763975,0.3617021276595745,0.24,99,96,3,53,40,3,1,2,54,0.5454545454545454,159,56,103,4
Obi Toppin,IND,307,5176,300,117.55524212505877,114.44381917088725,2165,0.21673003802281368,0.33014354066985646,0.26956521739130435,0.0625,113,95,18,50,39,6,2,16,50,0.4424778761061947,126,31,95,14
Patty Mills,UTA,230,5150,95,113.08516638465878,112.89254634884601,1907,0.22163588390501318,0.2153846153846154,0.30985915492957744,0.18309859154929578,26,23,3,8,13,2,0,3,11,0.4230769230769231,134,61,73,0
Josh Green,CHA,245,5135,-38,115.31082118188796,115.4538490999617,1449,0.21766561514195584,0.3082706766917293,0.2923076923076923,0.125,38,37,1,18,18,1,0,1,18,0.47368421052631576,168,75,93,1
Shake Milton,BKN,262,5115,151,113.16821268050111,111.87398257205783,2012,0.21666666666666667,0.33980582524271846,0.34951456310679613,0.23423423423423423,55,51,4,21,28,2,0,4,30,0.5454545454545454,119,47,72,0
Jae Crowder,SAC,200,5113,545,116.96012182354622,111.61376164227333,1516,0.18780889621087316,0.46808510638297873,0.3181818181818182,0.14814814814814814,72,71,1,36,35,0,0,1,32,0.4444444444444444,196,75,121,1
Mitchell Robinson,NYK,193,5058,102,115.35307061412281,114.17299240910907,789,0,0.4291044776119403,0.35294117647058826,0,322,302,20,201,91,10,3,17,189,0.5869565217391305,186,44,142,27
Jonathan Kuminga,GSW,232,5042,144,115.07532866327608,113.28042833922937,2505,0.20348837209302326,0.34782608695652173,0.27450980392156865,0.2631578947368421,102,96,6,42,52,2,2,4,61,0.5980392156862745,149,52,97,14
Drew Eubanks,UTA,298,5023,-694,110.99619475070739,117.25276860306975,1455,0.26666666666666666,0.3096446700507614,0.23555555555555555,0.076923077,266,261,5,192,68,1,0,5,159,0.5977443609022557,121,42,79,13
Will Barton,TOR,183,5005,162,115.21588775812667,113.89659270998416,1929,0.20075757575757575,0.45251396648044695,0.32,0.2773109243697479,67,57,10,31,26,0,6,4,30,0.44776119402985076,133,48,85,4
Naji Marshall,DAL,250,4966,206,114.8463496,112.02992906423088,1761,0.2454308093994778,0.36683417085427134,0.3440366972477064,0.2682926829268293,46,44,2,23,15,6,0,2,21,0.45652173913043476,181,75,106,0
Cameron Payne,NYK,261,4932,442,116.66666666666667,112.22024163200633,2165,0.26325757575757575,0.43548387096774194,0.35454545454545455,0.16,58,56,2,19,35,2,2,0,40,0.6896551724137931,163,85,78,0
Kenrich Williams,OKC,250,4901,106,111.86878727634195,110.48562933597621,1437,0.21766561514195584,0.3269230769230769,0.2713178294573643,0.16049382716049382,54,48,6,33,10,5,1,5,35,0.6481481481481481,188,64,124,4
Larry Nance Jr.,ATL,217,4893,7,112.70163335700518,112.11876388608363,1211,0.20320855614973263,0.410958904,0.19008264462809918,0.1724137931034483,96,94,2,48,46,0,0,2,59,0.6145833333333334,230,71,159,3
Steven Adams,HOU,189,4882,619,119.38171233564188,113.45341114912458,827,0,0.41064638783269963,0.21481481481481482,0,146,142,4,87,52,3,1,3,80,0.547945205,158,35,123,2
Maxi Kleber,DAL,203,4829,396,115.73160706946157,111.9386073341574,1056,0.19069767441860466,0.30612244897959184,0.2857142857142857,0.1111111111111111,160,153,7,88,63,2,2,5,99,0.61875,85,26,59,3
Garrison Mathews,ATL,268,4772,-606,111.33619399261552,117.5712143928036,1550,0.24044585987261147,0.25806451612903225,0.358974359,0.23076923076923078,47,36,11,22,14,0,7,4,22,0.46808510638297873,143,29,114,0
Cam Thomas,BKN,207,4766,-402,113.01355792933443,118.00310398344541,2833,0.26011560693641617,0.275,0.30982367758186397,0.29343629343629346,32,30,2,13,14,3,0,2,18,0.5625,110,37,73,4
Moritz Wagner,ORL,271,4704,-208,111.57340491430931,113.82659915262995,2317,0.19047619047619047,0.29389312977099236,0.23880597014925373,0,77,63,14,30,31,2,5,9,49,0.6363636363636364,143,59,84,2
John Konchar,MEM,254,4688,174,113.22707513972261,111.05838663090572,957,0.23548387096774193,0.36792452830188677,0.423728814,0.47619047619047616,113,100,13,59,39,2,5,8,72,0.6371681415929203,210,101,109,3
Gabe Vincent,LAL,221,4674,12,112.45440892512336,112.09720586660957,1482,0.21805792163543442,0.36363636363636365,0.45714285714285713,0.19402985074626866,21,18,3,10,8,0,1,2,6,0.2857142857142857,175,84,91,0
Evan Fournier,DET,181,4656,-322,110.86864853468269,114.6256345177665,2047,0.20402298850574713,0.37254901960784315,0.3352601156069364,0.16216216216216217,49,48,1,25,20,3,0,1,28,0.5714285714285714,171,62,109,0
Trey Lyles,SAC,248,4653,-51,114.93915232899707,115.69266344334665,1644,0.20082815734989648,0.3448275862068966,0.24369747899159663,0.15151515151515152,94,84,10,53,30,1,5,5,57,0.6063829787234043,89,30,59,7
Amir Coffey,LAC,257,4623,-250,112.27995758218452,114.50607501320654,1488,0.22162162162162163,0.4166666666666667,0.3691275167785235,0.26785714285714285,35,33,2,20,11,2,1,1,22,0.6285714285714286,110,39,71,0
Cory Joseph,ORL,229,4615,-519,110.97469840930927,116.31674304593413,1411,0.2565789473684211,0.4339622641509434,0.3258426966292135,0.21428571428571427,49,46,3,18,25,3,1,2,27,0.5510204081632653,143,55,88,0
Kevin Love,MIA,228,4595,246,114.13870725694072,112.04222317966394,2019,0.17979002624671916,0.4,0.2805755395683453,0.16049382716049382,44,44,0,32,12,0,0,0,25,0.5681818181818182,89,33,56,0
Bennedict Mathurin,IND,162,4579,-323,115.33742331288343,118.79487980018732,2315,0.2538860103626943,0.42424242424242425,0.336996337,0.225,35,34,1,27,6,1,1,0,22,0.6285714285714286,100,33,67,3
Dean Wade,CLE,229,4567,165,111.24686375040908,108.86501736111111,1103,0.23529411764705882,0.44642857142857145,0.2222222222222222,0.13333333333333333,80,80,0,53,26,1,0,0,37,0.4625,150,51,99,0
Jevon Carter,CHI,290,4489,88,113.05676855895197,111.02941176470588,1390,0.2281021897810219,0.3114754098360656,0.3076923076923077,0.24193548387096775,68,64,4,21,32,11,2,2,42,0.6176470588235294,159,71,88,0
Aaron Holiday,HOU,284,4445,110,112.97303175293607,111.25662950535772,1539,0.23513513513513515,0.30405405405405406,0.42792792792792794,0.2,41,41,0,19,20,2,0,0,23,0.5609756097560976,168,72,96,3
Marvin Bagley III,WAS,199,4437,-590,112.22539543057995,118.65393061045235,1752,0.1642512077294686,0.4103585657370518,0.25386996904024767,0.1276595744680851,107,106,1,61,45,0,0,1,66,0.61682243,87,30,57,21
Darius Bazley,UTA,176,4406,-1052,104.36068806836857,115.33093446734271,1602,0.18095238095238095,0.36,0.37222222222222223,0.075,136,116,20,67,38,11,6,14,91,0.6691176470588235,115,19,96,5
Quentin Grimes,DAL,190,4382,213,115.81591869361654,112.80390820268121,1405,0.25886524822695034,0.46236559139784944,0.35135135135135137,0.18181818181818182,49,42,7,23,16,3,1,6,28,0.5714285714285714,129,66,63,0
Landry Shamet,WAS,216,4373,83,113.37763012181617,112.35892896658554,1667,0.2126984126984127,0.37755102040816324,0.3333333333333333,0.30434782608695654,34,32,2,14,18,0,0,2,18,0.5294117647058824,110,38,72,0
Santi Aldama,MEM,195,4331,-37,112.6934639795123,113.5352632167207,1502,0.2281449893390192,0.38848920863309355,0.41025641025641024,0.15789473684210525,125,115,10,82,31,2,1,9,68,0.544,117,24,93,6
Brandon Clarke,MEM,209,4330,263,113.89134275618375,110.0635129215944,1646,0.25252525252525254,0.3675675675675676,0.2277580071174377,0.076923077,172,170,2,105,62,3,1,1,109,0.6337209302325582,158,47,111,6
Isaiah Joe,OKC,268,4289,747,117.44186046511628,111.5663196016297,1663,0.24311926605504589,0.3333333333333333,0.2777777777777778,0.23684210526315788,42,40,2,20,20,0,1,1,26,0.6190476190476191,135,50,85,0
Troy Brown Jr.,DET,235,4264,-160,112.9223069,114.67712596634834,1126,0.2230971128608924,0.3300970873786408,0.2564102564102564,0.1702127659574468,30,29,1,14,15,0,0,1,12,0.4,129,37,92,1
Joe Harris,DET,173,4261,296,116.63269927536233,114.5260989010989,1566,0.188911704,0.4074074074074074,0.2537313432835821,0.095238095,31,31,0,18,13,0,0,0,17,0.5483870967741935,90,29,61,0
Jalen McDaniels,TOR,232,4249,-444,111.21431028551773,115.89351005484461,1390,0.195906433,0.34594594594594597,0.3076923076923077,0.3,81,78,3,54,21,3,2,1,42,0.5185185185185185,156,69,87,7
Cody Martin,CHA,182,4230,-239,112.94913672421839,114.68038377066235,1071,0.2423076923076923,0.3146853146853147,0.3493975903614458,0.26582278481012656,81,63,18,44,14,5,5,13,48,0.5925925925925926,187,58,129,2
Josh Okogie,PHX,253,4217,-67,113.16455696202532,112.90911164328887,1064,0.20064724919093851,0.38202247191011235,0.43617021276595747,0.15789473684210525,102,89,13,39,41,9,8,5,58,0.5686274509803921,196,95,101,2
Aaron Wiggins,OKC,221,4214,-1,114.40972222222221,112.94413343996344,1402,0.20921985815602837,0.3389830508474576,0.34965034965034963,0.11764705882352941,51,50,1,32,16,2,0,1,29,0.5686274509803921,146,40,106,4
Mo Bamba,LAC,233,4193,-640,107.45231928420061,114.56891495601172,1331,0.1196808510638298,0.2962962962962963,0.28695652173913044,0.12307692307692308,291,281,10,134,139,8,5,5,182,0.6254295532646048,94,28,66,30
Terrence Ross,PHX,172,4125,-659,107.83018867924528,116.01183431952663,1744,0.24652087475149106,0.47058823529411764,0.32934131736526945,0.2112676056338028,43,37,6,17,16,4,2,4,25,0.5813953488372093,110,29,81,0
Xavier Tillman Sr.,BOS,242,4080,-40,111.21595795508838,111.1229946524064,1115,0.25157232704402516,0.32335329341317365,0.28272251308900526,0.5,124,121,3,78,40,3,1,2,78,0.6290322580645161,206,47,159,1
Cam Reddish,LAL,180,4075,-555,111.26676955953936,117.43759611972081,1367,0.21465968586387435,0.4407894736842105,0.3053435114503817,0.16923076923076924,58,54,4,26,27,1,1,3,25,0.43103448275862066,184,77,107,0
Andrew Nembhard,IND,154,4043,-208,115.95782490226277,118.36589698046181,1304,0.24573378839590443,0.4457831325301205,0.2731707317073171,0.19753086419753085,19,18,1,9,9,0,0,1,11,0.5789473684210527,145,46,99,1
Jaxson Hayes,LAL,258,4040,-183,110.86695485110471,112.49701314217442,1368,0.1095890410958904,0.36470588235294116,0.3474576271186441,0.1875,150,144,6,76,65,3,4,2,83,0.5533333333333333,116,25,91,12
Jalen Duren,DET,151,4000,-653,111.18300573800514,118.93736290519132,1191,0,0.35406698564593303,0.2331288343558282,0.071428571,135,134,1,84,49,1,0,1,79,0.5851851851851851,86,27,59,17
Jeremy Sochan,SAS,141,3958,-606,110.99381143065162,118.0607674615664,1392,0.2196078431372549,0.3593073593073593,0.3855932203389831,0.24074074074074073,69,65,4,43,21,1,0,4,42,0.6086956521739131,116,34,82,6
Daniel Theis,NOP,196,3944,-144,112.23012604517659,113.79997509029766,1213,0.18614718614718614,0.31496062992125984,0.20689655172413793,0.092592593,156,156,0,96,60,0,0,0,92,0.5897435897435898,89,28,61,19
Montrezl Harrell,PHI,197,3902,146,112.96178748254412,110.58882992165782,1695,0.3333333333333333,0.332,0.2658959537572254,0.11538461538461539,116,111,5,59,51,1,0,5,63,0.5431034482758621,92,30,62,3
Jalen Johnson,ATL,171,3887,-73,115.18879415347138,115.75367423782339,1557,0.19548872180451127,0.3446327683615819,0.35436893203883496,0.37142857142857144,108,100,8,63,37,0,2,6,61,0.5648148148148148,139,36,103,4
Damion Lee,PHX,198,3879,222,112.24872018978648,110.28930817610063,1315,0.22606382978723405,0.46,0.3416666666666667,0.20967741935483872,21,21,0,9,12,0,0,0,13,0.6190476190476191,109,25,84,2
Robert Williams III,POR,161,3863,495,115.69408740359897,109.5428203477141,986,0.6666666666666666,0.31851851851851853,0.29850746268656714,0.14285714285714285,293,267,26,97,158,12,7,19,167,0.5699658703071673,136,33,103,11
Tre Mann,CHA,181,3857,-403,108.57976900621905,114.42074338996039,1521,0.21476510067114093,0.34265734265734266,0.2794759825327511,0.25925925925925924,30,29,1,16,13,0,0,1,16,0.5333333333333333,145,52,93,1
Chuma Okeke,ORL,189,3831,-685,103.79827235772358,112.35726972849531,1047,0.188470067,0.4246575342465753,0.23469387755102042,0.19047619047619047,82,80,2,49,27,4,0,2,46,0.5609756097560976,173,47,126,3
Zach Collins,SAS,184,3809,-651,110.11404937962149,118.21370412125768,1595,0.18773946360153257,0.2857142857142857,0.24545454545454545,0.11666666666666667,136,135,1,94,40,1,1,0,87,0.6397058823529411,95,27,68,2
Oshae Brissett,BOS,208,3796,-25,116.1680458306811,115.5448920318222,1200,0.18018018018018017,0.3368421052631579,0.40860215053763443,0.125,70,63,7,40,23,0,2,5,43,0.6142857142857143,115,34,81,3
Richaun Holmes,WAS,191,3778,-290,113.08195459792228,116.95132913830743,1312,0.25,0.35668789808917195,0.21393034825870647,0.1891891891891892,169,168,1,106,62,0,1,0,94,0.5562130177514792,70,29,41,24
Ben Simmons,BKN,133,3767,313,115.87116802483507,111.23262995367988,1141,0.25,0.3,0.2863849765258216,0.16666666666666666,79,68,11,41,26,1,8,3,47,0.5949367088607594,174,60,114,3
Theo Maledon,PHX,177,3753,-1032,103.2603158430973,116.76034747061829,1280,0.18298969072164947,0.37142857142857144,0.3469387755102041,0.21428571428571427,34,32,2,18,13,1,0,2,18,0.5294117647058824,131,52,79,1
Thaddeus Young,PHX,207,3732,34,114.67073818374935,114.09814323607426,1212,0.2,0.38967136150234744,0.23148148148148148,0.2916666666666667,68,66,2,41,23,2,0,2,36,0.5294117647058824,205,96,109,2
Jalen Smith,CHI,229,3730,-101,116.17326669229783,117.07753225188401,1545,0.16573033707865167,0.32,0.23484848484848486,0.17647058823529413,158,156,2,107,48,1,0,2,94,0.5949367088607594,62,25,37,10
Walker Kessler,UTA,155,3691,-177,115.48625792811838,116.97494424767152,918,0.4375,0.45614035087719296,0.22857142857142856,0.5714285714285714,378,369,9,208,157,4,3,6,217,0.5740740740740741,64,7,57,25
Nick Richards,CHA,209,3647,-682,109.14864864864865,117.99811397009294,1016,0,0.3055555555555556,0.21739130434782608,0,183,182,1,135,47,0,1,0,113,0.6174863387978142,50,9,41,48
Sam Hauser,BOS,205,3631,810,120.9090909090909,110.6542822,1283,0.24770642201834864,0.25,0.35714285714285715,0.36363636363636365,53,52,1,27,25,0,0,1,26,0.49056603773584906,86,29,57,0
Christian Braun,DEN,180,3610,42,114.21131972043305,112.32728257924683,1184,0.21808510638297873,0.43636363636363634,0.39285714285714285,0.44,68,66,2,29,35,2,0,2,38,0.5588235294117647,111,32,79,0
Ochai Agbaji,TOR,161,3590,-376,113.63575538605646,118.06683530821462,1052,0.25663716814159293,0.4358974358974359,0.3125,0.18181818181818182,73,73,0,48,25,0,0,0,48,0.6575342465753424,87,25,62,4
Danilo Gallinari,MIL,166,3523,99,116.74600952114254,116.14040033831407,1571,0.18537859,0.3888888888888889,0.23333333333333334,0.19548872180451127,28,28,0,17,10,1,0,0,14,0.5,72,35,37,0
Bismack Biyombo,OKC,202,3520,-240,110.9170305676856,113.46664802125576,758,0,0.2962962962962963,0.2546583850931677,0,225,219,6,139,74,6,3,3,138,0.6133333333333333,58,25,33,13
Dennis Smith Jr.,BKN,170,3507,-263,108.23033707865169,111.1436541143654,1067,0.22705314009661837,0.3390804597701149,0.30666666666666664,0.21875,63,61,2,31,27,3,0,2,33,0.5238095238095238,211,91,120,1
Hamidou Diallo,WAS,168,3496,-417,107.0684627,112.85932509373697,1481,0.19696969696969696,0.41203703703703703,0.3271889400921659,0.086956522,57,54,3,25,29,0,0,3,32,0.5614035087719298,167,77,90,7
Carmelo Anthony,LAL,138,3483,-111,114.59436855310845,117.17058079032485,1667,0.22511848341232227,0.43103448275862066,0.25,0.20408163265306123,90,87,3,38,43,6,0,3,49,0.5444444444444444,93,34,59,5
Eric Bledsoe,LAC,125,3472,-107,112.5963289897716,113.76082704666108,1324,0.2314540059347181,0.41836734693877553,0.2903225806451613,0.15384615384615385,43,38,5,21,13,4,1,4,24,0.5581395348837209,124,31,93,1
Jose Alvarado,NOP,182,3454,412,116.21621621621621,110.13694762106452,1244,0.29411764705882354,0.39622641509433965,0.41358024691358025,0.24242424242424243,35,32,3,8,23,1,0,3,19,0.5428571428571428,214,109,105,0
Danny Green,PHI,144,3445,373,115.38134391834419,110.56378132118452,990,0.19495412844036697,0.3125,0.25,0.2222222222222222,96,90,6,45,36,9,2,4,54,0.5625,159,81,78,3
Davis Bertans,CHA,201,3436,31,113.8970280452072,114.42240045026031,1342,0.2159468438538206,0.20689655172413793,0.21739130434782608,0.11764705882352941,45,44,1,23,20,1,1,0,27,0.6,87,31,56,1
Aleksej Pokusevski,CHA,168,3429,-709,104.88421052631578,114.88345970233081,1096,0.18604651162790697,0.38392857142857145,0.35119047619047616,0.19480519480519481,136,124,12,75,47,2,3,9,75,0.5514705882352942,94,30,64,12
Ziaire Williams,BKN,171,3403,-267,111.17613474165002,114.22089890826598,1126,0.23690773067331672,0.3804347826086957,0.3431372549019608,0.23529411764705882,34,30,4,17,12,1,0,4,23,0.6764705882352942,105,29,76,1
Malaki Branham,SAS,159,3377,-801,109.1915370603895,119.84381536745225,1342,0.25745257452574527,0.3917525773195876,0.25136612021857924,0.20652173913043478,17,17,0,10,7,0,0,0,10,0.5882352941176471,67,15,52,0
Jaylen Nowell,NOP,190,3367,-113,112.50705019740552,114.55266138165345,1609,0.2236842105263158,0.4144736842105263,0.3256880733944954,0.22388059701492538,33,33,0,16,14,3,0,0,21,0.6363636363636364,96,43,53,0
Wesley Matthews,ATL,195,3365,162,113.9592072906119,110.7506817855605,708,0.24079320113314448,0.3333333333333333,0.3157894736842105,0.2,49,47,2,14,27,6,1,1,28,0.5714285714285714,97,41,56,0
Jordan Nwora,TOR,206,3358,-531,109.93929126076522,117.3863957098504,1370,0.2558139534883721,0.4857142857142857,0.24427480916030533,0.1875,52,51,1,35,16,0,0,1,35,0.6730769230769231,92,40,52,5
Austin Rivers,MIN,155,3341,-77,114.24763033175356,114.86068111455108,871,0.21630094043887146,0.32786885245901637,0.25757575757575757,0.4444444444444444,12,12,0,6,6,0,0,0,5,0.4166666666666667,109,47,62,0
Shaedon Sharpe,POR,128,3326,-647,110.5324922986651,119.86522121300908,1362,0.25139664804469275,0.3916083916083916,0.34513274336283184,0.17346938775510204,39,37,2,27,9,1,1,1,24,0.6153846153846154,79,25,54,10
Keita Bates-Diop,BKN,209,3318,-353,110.77215005108742,115.23505513639002,1024,0.23595505617977527,0.3877551020408163,0.3014705882352941,0.375,61,57,4,28,25,4,0,4,38,0.6229508196721312,109,38,71,0
Chimezie Metu,DET,213,3315,-234,111.29548762736535,114.33546140452698,1254,0.1487603305785124,0.1941747572815534,0.20945945945945946,0.16666666666666666,87,83,4,46,36,1,2,2,49,0.5632183908045977,130,34,96,14
Ricky Rubio,CLE,135,3308,43,111.20827867657776,110.98595669982446,1117,0.23885350318471338,0.34615384615384615,0.2805755395683453,0.14444444444444443,17,16,1,9,5,2,1,0,5,0.29411764705882354,173,66,107,0
Jordan McLaughlin,SAC,232,3302,149,112.15748485722526,109.83441324694024,812,0.19138755980861244,0.4019607843137255,0.3258426966292135,0.3333333333333333,27,27,0,12,15,0,0,0,9,0.3333333333333333,184,67,117,0
Raul Neto,CLE,182,3280,-94,112.45033112582782,113.73327451845316,1155,0.2097560975609756,0.37735849056603776,0.32954545454545453,0.16666666666666666,13,10,3,4,5,1,1,2,6,0.46153846153846156,145,52,93,0
Javonte Green,NOP,171,3264,-82,113.84800240312407,113.91614629794825,853,0.18125,0.3333333333333333,0.36507936507936506,0.6666666666666666,84,82,2,49,29,4,0,2,45,0.5357142857142857,156,58,98,1
Markelle Fultz,ORL,129,3263,-184,111.37546468401487,114.00980537810132,1331,0.20930232558139536,0.3772455089820359,0.2821576763485477,0.2152777777777778,48,48,0,25,18,5,0,0,29,0.6041666666666666,157,62,95,3
Rudy Gay,UTA,174,3211,370,114.25965339008818,108.63484341745212,1273,0.19230769230769232,0.417910448,0.32571428571428573,0.1565217391304348,77,74,3,35,37,2,1,2,51,0.6623376623376623,89,37,52,6
Chris Duarte,CHI,172,3207,-218,111.85819070904645,114.78605146946855,1188,0.28405797101449276,0.35833333333333334,0.3577981651376147,0.2268041237113402,27,27,0,13,14,0,0,0,18,0.6666666666666666,109,32,77,1
Lamar Stevens,MEM,203,3193,-140,111.18337563451777,111.96554424432263,1024,0.22012578616352202,0.47761194029850745,0.2411764705882353,0.18181818181818182,72,69,3,45,23,1,0,3,37,0.5138888888888888,98,37,61,3
Ish Smith,CHA,195,3188,-421,109.52308626974484,115.37414965986393,884,0.19117647058823528,0.31666666666666665,0.26506024096385544,0.1921182266009852,47,38,9,12,22,4,4,5,23,0.48936170212765956,104,51,53,0
Goga Bitadze,ORL,216,3182,92,114.25251742835012,112.70504487774681,860,0.20512820512820512,0.43478260869565216,0.21518987341772153,0,233,225,8,140,82,3,2,6,144,0.6180257510729614,94,28,66,28
Dyson Daniels,ATL,143,3176,27,114.61783923415894,113.2439355,791,0.22277227722772278,0.4270833333333333,0.34615384615384615,0.3333333333333333,56,56,0,31,23,2,0,0,32,0.5714285714285714,201,98,103,3
Nassir Little,PHX,189,3163,-341,113.41903119611224,118.375,1017,0.23024054982817868,0.42857142857142855,0.2711864406779661,0.2222222222222222,79,76,3,49,24,3,2,1,42,0.5316455696202531,60,8,52,2
Furkan Korkmaz,PHI,194,3129,223,112.94007197621656,109.33104095029697,1106,0.25757575757575757,0.4722222222222222,0.35514018691588783,0.23333333333333334,24,22,2,11,10,1,1,1,9,0.375,106,28,78,0
R.J. Hampton,MIA,170,3116,-816,105.06091846298033,117.40348692403488,1032,0.24110671936758893,0.36585365853658536,0.3151515151515151,0.29411764705882354,32,28,4,10,15,3,1,3,19,0.59375,90,28,62,7
Garrett Temple,TOR,175,3108,-373,108.59643638637074,113.85692068429239,796,0.2687074829931973,0.35294117647058826,0.30612244897959184,0.125,59,54,5,31,22,1,0,5,42,0.711864407,111,59,52,0
Trendon Watford,BKN,184,3106,-644,109.54258675078864,119.17399497487438,1178,0.28225806451612906,0.3816793893129771,0.23626373626373626,0.14285714285714285,63,57,6,33,21,3,1,5,39,0.6190476190476191,85,34,51,1
Lonzo Ball,CHI,98,3094,157,115.26324011873145,113.19956105972723,1170,0.20045045045045046,0.43661971830985913,0.42105263157894735,0.1780821917808219,66,63,3,36,24,3,1,2,34,0.5151515151515151,155,38,117,0
Brandon Miller,CHA,94,3071,-606,110.27175671303785,120.21052631578948,1553,0.2097902097902098,0.38372093023255816,0.3316831683168317,0.21978021978021978,57,51,6,32,19,0,3,3,36,0.631578947,89,27,62,8
Bones Hyland,LAC,172,3039,-187,113.89791937581273,117.14704445530045,1575,0.23404255319148937,0.46846846846846846,0.32515337423312884,0.2777777777777778,41,31,10,12,17,2,3,7,24,0.5853658536585366,113,33,80,0
Malachi Flynn,DET,213,3032,-344,109.26496835956515,114.99593826157596,1060,0.27548209366391185,0.4050632911392405,0.304,0.23595505617977527,23,21,2,9,11,1,0,2,12,0.5217391304347826,117,55,62,0
Haywood Highsmith,MIA,159,3006,-92,110.93541944074568,111.83382985766302,729,0.20502092050209206,0.36363636363636365,0.2786885245901639,0.23076923076923078,66,58,8,29,27,2,1,7,33,0.5,115,48,67,3
Svi Mykhailiuk,UTA,201,3003,-125,109.89028718941594,112.21485196570134,1110,0.22041763341067286,0.34782608695652173,0.2702702702702703,0.17857142857142858,22,21,1,12,8,1,0,1,12,0.5454545454545454,108,31,77,1
JaMychal Green,GSW,182,3002,-147,112.29656419529837,114.54366382140512,974,0.1890909090909091,0.475,0.3275862068965517,0.25925925925925924,71,67,4,30,36,1,3,1,44,0.6197183098591549,94,50,44,1
Danuel House Jr.,PHI,168,2975,-156,111.50384552446408,113.92611964694345,874,0.24354243542435425,0.32142857142857145,0.24444444444444444,0.32142857142857145,47,47,0,29,16,2,0,0,26,0.5531914893617021,70,13,57,2
DeAndre Jordan,DEN,190,2948,-419,111.04622059068913,116.94494957844272,756,0,0.30656934306569344,0.35294117647058826,0.4,141,138,3,71,65,2,1,2,90,0.6382978723404256,49,17,32,7
Moses Moody,GSW,204,2938,20,113.12068398553107,113.16397228637413,1055,0.24464831804281345,0.352112676,0.35294117647058826,0.43333333333333335,47,42,5,20,18,4,2,3,29,0.6170212765957447,73,34,39,0
Paul Reed,DET,226,2932,66,115.49319727891157,113.7901861252115,826,0.125,0.4715909090909091,0.19852941176470587,0,167,159,8,86,68,5,2,6,106,0.6347305389221557,164,75,89,5
Miles McBride,NYK,190,2922,222,116.1751875763392,111.40730482949627,948,0.23668639053254437,0.3870967741935484,0.345679012,0.26666666666666666,21,20,1,7,12,1,0,1,9,0.42857142857142855,118,42,76,2
Dario Saric,DEN,181,2910,191,116.0645269702571,113.65713318666441,1190,0.23972602739726026,0.21052631578947367,0.2642857142857143,0.12195121951219512,21,21,0,6,15,0,0,0,14,0.6666666666666666,87,39,48,0
Bryn Forbes,MIN,170,2908,78,114.45029624753127,113.85991058122205,1333,0.22164948453608246,0.4838709677419355,0.2828282828282828,0.25,8,7,1,6,1,0,0,1,5,0.625,56,23,33,0
Ty Jerome,CLE,152,2860,-191,109.16765152794193,113.75598086124401,1184,0.22875816993464052,0.3548387096774194,0.3087248322147651,0.23333333333333334,17,16,1,6,9,1,0,1,6,0.35294117647058826,102,51,51,0
Juan Toscano-Anderson,SAC,189,2854,-13,110.91185924547455,110.08882185352773,706,0.1702127659574468,0.4177215189873418,0.32142857142857145,0,54,53,1,26,26,1,1,0,20,0.37037037037037035,106,39,67,6
Isaiah Roby,SAS,148,2847,-732,103.69998325799432,115.93572145965851,1008,0.17261904761904762,0.37142857142857144,0.42857142857142855,0.071428571,78,74,4,46,28,0,1,3,50,0.6410256410256411,106,34,72,12
Simone Fontecchio,DET,141,2825,-253,112.32968881412951,117.01840283640048,1011,0.2680965147453083,0.4225352112676056,0.3953488372093023,0.24,36,35,1,21,14,0,1,0,26,0.7222222222222222,65,24,41,2
James Wiseman,IND,148,2799,-840,105.84426648492078,119.6877121520706,1096,0.16666666666666666,0.336,0.20689655172413793,0.10144927536231885,102,102,0,56,44,2,0,0,63,0.6176470588235294,30,14,16,29
Tristan Thompson,CLE,168,2790,-68,115.57699178277957,115.77828935718081,641,1,0.3508771929824561,0.2214765100671141,0.25,70,70,0,41,29,0,0,0,44,0.6285714285714286,59,19,40,11
Mike Muscala,OKC,194,2783,156,112.18091485352065,110.51175656984785,1075,0.2066326530612245,0.40384615384615385,0.15555555555555556,0.076923077,74,73,1,35,38,0,0,1,49,0.6621621621621622,50,24,26,0
Kris Dunn,LAC,131,2764,-82,115.04685872960778,116.32865314612584,838,0.31756756756756754,0.32857142857142857,0.34831460674157305,0.0625,50,47,3,17,27,3,0,3,28,0.56,159,68,91,1
George Hill,IND,130,2758,345,114.07525736599219,108.14366998577525,757,0.25133689839572193,0.38596491228070173,0.35,0.22727272727272727,17,14,3,8,5,1,0,3,10,0.5882352941176471,91,28,63,0
Tari Eason,HOU,126,2752,31,113.58523725834799,112.64448336252188,909,0.28804347826086957,0.4772727272727273,0.48484848484848486,0.23809523809523808,89,82,7,32,46,4,2,5,54,0.6067415730337079,173,80,93,2
Jeremiah Robinson-Earl,NOP,156,2743,-407,108.2814999111427,115.02388957706602,776,0.172,0.36220472440944884,0.18518518518518517,0.16666666666666666,33,33,0,18,15,0,0,0,20,0.6060606060606061,82,20,62,1
Victor Wembanyama,SAS,90,2717,-94,111.95324951301576,113.47718429430492,1718,0.1945945945945946,0.41353383458646614,0.24175824175824176,0.11403508771929824,318,304,14,196,95,13,4,10,216,0.6792452830188679,111,36,75,15
Keyonte George,UTA,97,2717,-546,112.05293276108726,121.44767338206454,1227,0.27889447236180903,0.2553191489361702,0.3793103448275862,0.12244897959183673,9,8,1,4,4,0,0,1,2,0.2222222222222222,53,14,39,1
Taj Gibson,CHA,178,2717,89,111.22296793437732,109.33953488372093,538,0.22413793103448276,0.3780487804878049,0.3225806451612903,0.12121212121212122,111,100,11,46,49,5,8,3,64,0.5765765765765766,76,38,38,2
Blake Griffin,BOS,143,2714,69,114.30123099203475,113.03167420814479,890,0.1371841155234657,0.4954954954954955,0.2878787878787879,0.29411764705882354,38,38,0,22,16,0,0,0,19,0.5,73,26,47,3
Goran Dragic,MIL,129,2704,51,113.88587937883712,113.2102786825914,1084,0.2491103202846975,0.3611111111111111,0.2814814814814815,0.14285714285714285,16,16,0,7,9,0,0,0,11,0.6875,65,18,47,0
Khem Birch,TOR,142,2682,-100,111.58854166666667,113.00722623679822,600,0.15384615384615385,0.40860215053763443,0.3053435114503817,0.20833333333333334,80,78,2,42,34,2,2,0,49,0.6125,83,25,58,10
Chet Holmgren,OKC,92,2677,514,120.55406613047363,111.16859946476362,1306,0.1729957805907173,0.33663366336633666,0.21311475409836064,0.088235294,216,212,4,150,60,2,2,2,141,0.6527777777777778,61,19,42,10
Facundo Campazzo,DAL,138,2661,-123,110.31642014604007,111.71991084695394,683,0.22924901185770752,0.3541666666666667,0.19148936170212766,0.26666666666666666,37,29,8,10,19,0,1,7,18,0.4864864864864865,148,55,93,0
Derrick Rose,MEM,127,2652,163,110.76894363568496,107.9685746352413,1296,0.255,0.39473684210526316,0.38578680203045684,0.23076923076923078,38,28,10,13,12,3,5,5,18,0.47368421052631576,86,34,52,1
David Roddy,ATL,149,2640,-350,110.30890148053372,115.96440247003268,832,0.24723247232472326,0.4205607476635514,0.3619047619047619,0.15384615384615385,33,31,2,17,14,0,2,0,16,0.48484848484848486,62,30,32,0
Gary Payton II,GSW,170,2636,328,117.85982008995502,109.75879211931503,815,0.22758620689655173,0.4050632911392405,0.3888888888888889,0,55,48,7,23,23,2,4,3,33,0.6,180,68,112,1
Kendrick Nunn,WAS,126,2614,-61,113.51911127847863,114.47368421052632,1210,0.21341463414634146,0.36904761904761907,0.3269230769230769,0.171875,21,19,2,9,8,2,1,1,13,0.6190476190476191,80,32,48,0
Stanley Johnson,SAS,139,2569,-299,113.13744075829383,117.16208637128435,687,0.2023121387283237,0.36363636363636365,0.38461538461538464,0,38,34,4,18,15,1,0,4,20,0.5263157894736842,111,40,71,2
Yuta Watanabe,MEM,180,2560,-169,110.88808937701192,114.45668693009118,732,0.226890756,0.3090909090909091,0.2459016393442623,0.15789473684210525,59,59,0,28,30,1,0,0,31,0.5254237288135594,74,23,51,0
Luke Kornet,BOS,196,2545,411,118.83154819863681,110.84924035839501,576,0.10344827586206896,0.336734694,0.28888888888888886,1,163,155,8,76,73,6,5,3,99,0.6073619631901841,51,11,40,3
JaVale McGee,SAC,208,2544,-19,110.65542353392104,110.99827553171106,1098,0.1,0.43023255813953487,0.26136363636363635,0.17647058823529413,181,177,4,104,69,4,2,2,111,0.6132596685082873,59,17,42,35
Jabari Walker,POR,147,2524,-477,108.45616757176106,118.16588785046729,695,0.31724137931034485,0.40441176470588236,0.3482142857142857,0.2608695652173913,38,38,0,30,8,0,0,0,20,0.5263157894736842,58,24,34,2
Brandin Podziemski,GSW,96,2510,297,118.55831217034577,112.66835838375953,756,0.25757575757575757,0.32786885245901637,0.34285714285714286,0.19047619047619047,21,18,3,4,12,2,1,2,13,0.6190476190476191,78,25,53,2
Jaime Jaquez Jr.,MIA,93,2499,79,115.13632718524458,113.03133107164238,945,0.24358974358974358,0.46153846153846156,0.31386861313868614,0.11764705882352941,22,22,0,12,10,0,0,0,17,0.7727272727272727,96,30,66,1
Julian Champagnie,SAS,115,2499,-196,113.01763803680983,116.3292589763178,862,0.23867069486404835,0.3148148148148148,0.35555555555555557,0.45454545454545453,62,57,5,26,31,0,2,3,30,0.4838709677419355,74,27,47,3
Jock Landale,HOU,193,2486,282,114.8248500096768,109.17697063369398,825,0.2565789473684211,0.352,0.25,0.125,83,80,3,38,40,2,1,2,50,0.6024096385542169,49,7,42,2
Zeke Nnaji,DEN,209,2472,-457,106.06610237807337,114.24006391052527,660,0.2054794520547945,0.3185840707964602,0.24444444444444444,0.21428571428571427,80,76,4,43,29,4,1,3,44,0.55,57,15,42,5
Kemba Walker,DAL,89,2461,-90,112.75275275275274,114.80738362760835,1247,0.2265193370165746,0.4342105263157895,0.3469387755102041,0.30526315789473685,21,19,2,12,6,1,0,2,9,0.42857142857142855,76,32,44,0
James Johnson,IND,143,2460,-188,110.09356957993232,112.75882468941037,689,0.20754716981132076,0.3770491803278688,0.32,0.13333333333333333,84,73,11,34,33,6,2,9,41,0.4880952380952381,84,29,55,0
Toumani Camara,POR,94,2459,-330,108.08323329331733,114.52547452547454,543,0.24,0.3137254901960784,0.3384615384615385,0.6,41,39,2,25,13,1,0,2,23,0.5609756097560976,100,31,69,5
Terence Davis,SAC,155,2451,39,114.42251319132303,113.41653666146645,1162,0.2285012285012285,0.4090909090909091,0.265625,0.18518518518518517,37,34,3,22,12,0,0,3,20,0.5405405405405406,112,39,73,1
Bilal Coulibaly,WAS,84,2441,-713,107.56902877003283,121.19575699132112,714,0.17543859649122806,0.325,0.32,0.2903225806451613,63,58,5,29,29,0,1,4,36,0.5714285714285714,89,40,49,2
Isaiah Jackson,IND,163,2438,-123,115.27371907266706,117.14507370054305,883,0.18518518518518517,0.3977272727272727,0.3617021276595745,0.16666666666666666,214,199,15,125,68,6,4,11,125,0.5841121495327103,93,32,61,17
Dalano Banton,POR,171,2399,-185,109.5257647300349,113.39359079704191,991,0.375,0.4274193548387097,0.34810126582278483,0.2653061224489796,56,49,7,17,28,4,3,4,31,0.5535714285714286,95,35,60,0
Josh Jackson,SAC,113,2390,-276,106.98770491803279,112.09216965742252,1021,0.20155038759689922,0.4380165289256198,0.4198473282442748,0.18333333333333332,69,64,5,41,21,2,3,2,34,0.4927536231884058,79,33,46,3
Victor Oladipo,MIA,83,2359,-111,110.15673981191222,112.24191866527632,1122,0.22012578616352202,0.3333333333333333,0.2702702702702703,0.13924050632911392,27,27,0,16,10,1,0,0,12,0.4444444444444444,108,54,54,1
Thomas Bryant,MIA,144,2348,-149,113.28786939450299,116.39107069036791,959,0.16666666666666666,0.37209302325581395,0.25882352941176473,0.11627906976744186,84,80,4,46,32,2,1,3,49,0.5833333333333334,37,7,30,10
Alex Len,SAC,195,2334,-63,110.81190524397651,112.45175705870405,656,0.2,0.3670886075949367,0.23478260869565218,0,144,142,2,62,77,3,0,2,92,0.6388888888888888,51,13,38,4
Robin Lopez,MIL,160,2329,-159,107.9753340184995,112.30545756380992,820,0.13636363636363635,0.4146341463414634,0.17647058823529413,0,73,73,0,41,32,0,0,0,40,0.547945205,20,5,15,2
Otto Porter Jr.,TOR,114,2329,174,111.9624217118998,109.05842791088693,731,0.21171171171171171,0.4594594594594595,0.3382352941176471,0.11538461538461539,38,38,0,14,24,0,0,0,22,0.5789473684210527,100,27,73,0
Damian Jones,CLE,175,2309,-415,106.54088050314465,115.26525477039212,709,0.11428571428571428,0.3333333333333333,0.2653061224489796,0.047619047619047616,110,110,0,68,41,1,0,0,63,0.5727272727272728,52,14,38,13
Nerlens Noel,BKN,106,2303,-146,109.57795757708288,112.27955584585239,319,0,0.35384615384615387,0.14,0,182,180,2,136,42,2,1,1,110,0.6043956043956044,116,57,59,16
Cason Wallace,OKC,105,2297,241,117.04111911827046,110.85222502099076,639,0.21787709497206703,0.42857142857142855,0.24074074074074073,0.3333333333333333,53,45,8,14,29,2,2,6,30,0.5660377358490566,117,65,52,0
Bol Bol,PHX,165,2252,-199,109.26243567753002,113.50482315112541,793,0.2222222222222222,0.4864864864864865,0.3883495145631068,0.28,122,102,20,49,46,7,6,14,78,0.639344262,44,11,33,12
Jericho Sims,NYK,161,2249,-25,112.82633371169126,112.55069851284361,279,0,0.4634146341463415,0.15789473684210525,0,78,77,1,45,31,1,0,1,46,0.5897435897435898,40,10,30,4
Peyton Watson,DEN,125,2222,-135,113.18631863186319,114.06802120141343,731,0.15217391304347827,0.3229166666666667,0.29069767441860467,0.066666667,121,109,12,72,35,2,3,9,67,0.5537190082644629,62,25,37,8
Lou Williams,ATL,122,2222,92,114.97361477572561,113.80150642445724,1028,0.18902439024390244,0.45454545454545453,0.3157894736842105,0.22818791946308725,9,8,1,4,4,0,1,0,5,0.5555555555555556,75,22,53,1
Tomas Satoransky,WAS,113,2213,-165,110.25871766029246,113.46024636058232,590,0.21428571428571427,0.30952380952380953,0.19767441860465115,0.21428571428571427,19,18,1,14,4,0,0,1,7,0.3684210526315789,69,26,43,0
Scoot Henderson,POR,79,2211,-604,108.13747228381375,121.31474103585657,977,0.25853658536585367,0.40268456375838924,0.31543624161073824,0.21621621621621623,15,13,2,7,5,1,1,1,9,0.6,64,30,34,0
Kevin Knox II,DET,166,2199,-414,107.35326205542222,116.25980819529207,817,0.19636363636363635,0.3050847457627119,0.4117647058823529,0.28125,27,26,1,12,14,0,1,0,17,0.6296296296296297,53,13,40,2
Ben McLemore,POR,117,2190,-451,105.65954635542833,115.5149647887324,957,0.22727272727272727,0.3333333333333333,0.23809523809523808,0.20833333333333334,19,19,0,11,8,0,0,0,9,0.47368421052631576,61,19,42,1
Elfrid Payton,NOP,120,2177,-151,108.75228519195613,111.48955495004542,722,0.22784810126582278,0.3395061728395062,0.35353535353535354,0.2727272727272727,18,16,2,7,9,0,0,2,10,0.5555555555555556,82,27,55,0
Enes Freedom,BOS,107,2169,224,120.4441391941392,115.50103187342353,548,0.2,0.3806818181818182,0.24358974358974358,0.5,62,60,2,40,18,2,0,2,36,0.5806451612903226,38,18,20,0
Jordan Goodwin,MEM,121,2167,-218,109.08677873693775,113.5489708210812,624,0.1834319526627219,0.4473684210526316,0.304,0.2830188679245283,44,41,3,22,19,0,1,2,29,0.6590909090909091,106,60,46,0
Dwight Howard,LAL,129,2166,-195,109.93845452473217,113.40112994350282,534,0.23809523809523808,0.3787878787878788,0.2,0.090909091,98,94,4,54,39,1,0,4,55,0.5612244897959183,64,28,36,21
Willy Hernangomez,NOP,133,2143,-40,114.62706565430996,114.80248557478916,785,0.090909091,0.40703517587939697,0.2608695652173913,0.16666666666666666,55,54,1,26,28,0,1,0,25,0.45454545454545453,60,28,32,4
Josh Christopher,HOU,138,2120,-497,109.0162063455832,120.4431247144815,863,0.2756756756756757,0.3707865168539326,0.3023255813953488,0.21428571428571427,28,26,2,11,14,1,1,1,19,0.6785714285714286,98,41,57,6
Markieff Morris,DAL,142,2088,-16,110.82462253193961,111.2221189591078,650,0.19313304721030042,0.42857142857142855,0.14285714285714285,0.22807017543859648,29,29,0,17,8,4,0,0,17,0.5862068965517241,42,8,34,3
Justise Winslow,POR,103,2058,-86,109.89399293286219,111.23858581128542,549,0.23076923076923078,0.44,0.36,0.20454545454545456,48,47,1,30,16,1,0,1,33,0.6875,80,31,49,5
Andre Iguodala,GSW,102,2054,67,110.13712047012731,107.34011627906976,387,0.18128654970760233,0.5,0.2857142857142857,0.2,60,57,3,17,36,4,2,1,34,0.5666666666666667,88,32,56,3
Isaiah Livers,DET,94,2051,-411,111.16435074269286,120.4339532665713,522,0.27102803738317754,0.2777777777777778,0.38461538461538464,0.3333333333333333,40,38,2,16,21,1,1,1,23,0.575,54,20,34,1
John Wall,LAC,74,2043,-272,107.86993402450518,114.22515308525671,1124,0.23553719008264462,0.32450331125827814,0.3333333333333333,0.1366906474820144,43,43,0,19,22,2,0,0,24,0.5581395348837209,69,33,36,0
Amen Thompson,HOU,86,2034,140,114.48243114909782,110.06111894687353,701,0.19696969696969696,0.41739130434782606,0.3048780487804878,0.125,60,53,7,23,28,2,2,5,40,0.6666666666666666,105,61,44,3
JT Thor,CLE,168,2027,-215,108.14708002883923,112.71814487210136,453,0.17419354838709677,0.3333333333333333,0.45652173913043476,0.25,63,59,4,35,24,0,2,2,38,0.6031746031746031,43,17,26,12
Jaden Hardy,DAL,143,2018,-157,112.09544058587291,116.60323501427213,1015,0.17735849056603772,0.39622641509433965,0.34951456310679613,0.171875,12,12,0,4,7,1,0,0,8,0.6666666666666666,53,25,28,0
Serge Ibaka,MIL,111,2018,78,113.60411059456816,112.49383932971908,694,0.14666666666666667,0.30357142857142855,0.2621359223300971,0.088888889,87,86,1,40,46,0,0,1,54,0.6206896551724138,22,11,11,4
D.J. Augustin,LAL,112,2012,-216,113.19528052010594,119.5187165775401,676,0.1891891891891892,0.40384615384615385,0.2413793103448276,0.30434782608695654,2,2,0,0,2,0,0,0,1,0.5,45,13,32,0
Avery Bradley,LAL,89,2008,-312,107.87629862285576,114.74897910160941,509,0.22279792746113988,0.2222222222222222,0.358974359,0.21052631578947367,12,10,2,3,6,1,0,2,6,0.5,74,32,42,0
DeAndre' Bembry,MIL,107,1998,-21,112.30051559047386,111.82769530299342,510,0.24561403508771928,0.3875,0.4,0,43,41,2,23,15,3,1,1,20,0.46511627906976744,102,17,85,1
Brandon Boston Jr.,NOP,127,1961,-292,107.1304347826087,114.01684001981178,827,0.25806451612903225,0.5287356321839081,0.32727272727272727,0.19230769230769232,26,23,3,15,8,0,1,2,12,0.46153846153846156,79,23,56,1
Juancho Hernangomez,TOR,134,1958,-63,115.44817225838759,116.90845422711357,496,0.28431372549019607,0.4406779661016949,0.4074074074074074,1,23,23,0,12,11,0,0,0,10,0.43478260869565216,49,13,36,1
Saben Lee,PHX,134,1943,-184,107.53857829496584,111.51621825496605,650,0.20224719101123595,0.3984375,0.3181818181818182,0.23076923076923078,29,26,3,15,9,2,1,2,15,0.5172413793103449,94,56,38,0
Day'Ron Sharpe,BKN,144,1908,19,115.1709951144253,114.71193415637859,544,0.13636363636363635,0.42196531791907516,0.3194444444444444,0,92,91,1,51,40,0,0,1,54,0.5869565217391305,53,17,36,13
Frank Jackson,UTA,94,1907,-200,107.45118191161356,112.0429557657888,858,0.21785714285714286,0.375,0.2716049382716049,0.23333333333333334,10,10,0,6,3,1,0,0,7,0.7,42,11,31,0
Anthony Gill,WAS,197,1903,29,114.48906964921198,112.38071320944249,544,0.15555555555555556,0.375,0.3918918918918919,0,39,39,0,18,21,0,0,0,21,0.5384615384615384,40,20,20,3
Max Christie,LAL,131,1899,-186,111.14762386248735,115.12182868625973,521,0.22556390977443608,0.2972972972972973,0.21428571428571427,0.23809523809523808,33,30,3,13,15,2,0,3,21,0.6363636363636364,47,9,38,2
Romeo Langford,SAS,109,1898,-242,107.25868725868726,112.30259806418748,469,0.25225225225225223,0.38333333333333336,0.3522727272727273,0.25,34,33,1,16,17,0,0,1,18,0.5294117647058824,52,22,30,2
Cody Zeller,NOP,133,1896,11,114.2308676734067,114.47672923630753,580,0.125,0.39285714285714285,0.3770491803278688,0.2,32,32,0,17,15,0,0,0,11,0.34375,47,22,25,2
Gradey Dick,TOR,79,1885,-428,110.52631578947367,120.8014293006636,741,0.26609442060085836,0.3235294117647059,0.38095238095238093,0.16666666666666666,7,6,1,3,3,0,0,1,5,0.7142857142857143,52,10,42,0
Sterling Brown,LAL,104,1881,-125,108.25167612171222,111.10254433307634,513,0.15675675675675677,0.40384615384615385,0.4642857142857143,0.38461538461538464,19,19,0,8,10,1,0,0,9,0.47368421052631576,55,23,32,0
Kent Bazemore,LAL,106,1878,47,110.01011122345803,108.1386586284853,541,0.21710526315789475,0.38596491228070173,0.19148936170212766,0.066666667,42,38,4,23,14,1,0,4,18,0.42857142857142855,94,47,47,0
Dwayne Bacon,ORL,72,1853,-443,104.10922587486745,115.27301503561067,696,0.19727891156462585,0.37755102040816324,0.3,0.16666666666666666,5,5,0,3,2,0,0,0,3,0.6,45,17,28,0
Sam Merrill,CLE,123,1835,63,112.6239614044492,111.95563970787126,692,0.2042042042042042,0.4444444444444444,0.4444444444444444,0.42857142857142855,10,9,1,9,0,0,1,0,2,0.2,43,18,25,0
Wayne Ellington,LAL,89,1822,-128,111.53225806451611,115.43859649122808,686,0.156794425,0.46153846153846156,0.5,0.10526315789473684,14,12,2,6,5,1,0,2,9,0.6428571428571429,41,15,26,0
Tony Snell,NOP,100,1815,-53,112.96144380639869,114.56736035049288,378,0.25,0.3076923076923077,0.3333333333333333,0.3333333333333333,20,19,1,15,2,2,0,1,15,0.75,29,10,19,1
Jaylin Williams,OKC,118,1811,33,116.14806866952789,114.70902295782167,508,0.2727272727272727,0.4166666666666667,0.22413793103448276,0.3,39,38,1,25,12,1,1,0,28,0.717948718,56,12,44,2
Moses Brown,IND,150,1804,-455,104.35356200527706,116.17492096944152,499,0,0.37037037037037035,0.3333333333333333,0,85,83,2,51,32,0,0,2,54,0.6352941176470588,49,18,31,18
Jake LaRavia,MEM,95,1804,-22,112.5066809192945,112.58313381218409,615,0.30113636363636365,0.3382352941176471,0.5454545454545454,0.5555555555555556,33,27,6,12,14,1,3,3,12,0.36363636363636365,63,29,34,0
Anthony Black,ORL,95,1787,12,109.7452934662237,108.87052341597797,463,0.2647058823529412,0.3508771929824561,0.3076923076923077,0.25,42,37,5,17,18,2,2,3,24,0.5714285714285714,58,26,32,2
Trent Forrest,ATL,151,1758,-123,112.17217787913341,115.48093340922026,385,0.20408163265306123,0.4,0.36363636363636365,1,15,14,1,11,3,0,0,1,8,0.5333333333333333,57,25,32,1
Blake Wesley,SAS,117,1757,-350,107.23185265438786,116.08297413793105,472,0.2375,0.297029703,0.3114754098360656,0.23684210526315788,15,14,1,6,7,1,0,1,4,0.26666666666666666,62,23,39,0
Kira Lewis Jr.,UTA,131,1745,-88,107.99780881950151,110.62019758507135,634,0.2484472049689441,0.4,0.40594059405940597,0.11764705882352941,15,14,1,2,10,2,0,1,7,0.4666666666666667,68,27,41,0
Nemanja Bjelica,GSW,108,1738,64,112.39716312056737,111.78663607685691,573,0.13245033112582782,0.37037037037037035,0.4,0.375,31,31,0,15,16,0,0,0,22,0.7096774193548387,56,23,33,2
Timothe Luwawu-Cabarrot,ATL,110,1735,-77,114.27782380557856,115.8922188616992,540,0.23829787234042554,0.22033898305084745,0.4,0.4444444444444444,12,10,2,7,3,0,1,1,6,0.5,51,16,35,0
Dereck Lively II,DAL,74,1734,255,122.06255283178359,114.7481001970166,515,0,0.34328358208955223,0.3157894736842105,0,108,108,0,63,44,1,0,0,64,0.5925925925925926,47,14,33,16
LaMarcus Aldridge,BKN,73,1725,-15,113.50664029386833,114.38297872340425,825,0.15384615384615385,0.37735849056603776,0.1485148514851485,0.16666666666666666,76,76,0,47,29,0,0,0,37,0.4868421052631579,25,5,20,0
Caleb Houstan,ORL,126,1716,-128,110.49436253252384,113.83285302593659,417,0.30666666666666664,0.4,0.5,0.25,13,11,2,6,5,0,1,1,6,0.46153846153846156,27,10,17,0
Hassan Whiteside,UTA,101,1708,125,118.23935558112774,114.44572085008616,553,0,0.23076923076923078,0.225,0.15384615384615385,149,147,2,72,69,6,2,0,95,0.6375838926174496,31,9,22,4
Wenyen Gabriel,MEM,120,1704,-4,113.72604284103721,113.13725490196077,442,0.19696969696969696,0.5052631578947369,0.35,0.6666666666666666,56,55,1,35,19,1,0,1,36,0.6428571428571429,42,20,22,5
Dewayne Dedmon,PHI,121,1702,-8,112.1849985176401,110.97453906935908,569,0.1111111111111111,0.3780487804878049,0.23333333333333334,0.23529411764705882,67,67,0,44,21,2,0,0,33,0.4925373134328358,42,16,26,4
Jeremy Lamb,SAC,92,1701,7,114.39588688946016,114.35926773455377,680,0.20118343195266272,0.325,0.38,0.21052631578947367,45,39,6,22,15,2,1,5,29,0.6444444444444445,65,24,41,0
Derrick Favors,OKC,107,1692,-105,110.33478893740902,113.02959953569355,443,0.1875,0.44776119402985076,0.14,0.12195121951219512,80,79,1,57,21,1,1,0,56,0.7,49,11,38,0
Sandro Mamukelashvili,SAS,147,1679,-207,107.816092,114.25685425685427,560,0.15822784810126583,0.379746835,0.15217391304347827,0.4,38,37,1,26,11,0,0,1,22,0.5789473684210527,33,11,22,2
Bryce McGowens,POR,106,1671,-370,106.03322646458757,116.5455074149462,499,0.21666666666666667,0.34285714285714286,0.3181818181818182,0.23076923076923078,16,16,0,13,3,0,0,0,8,0.5,36,16,20,1
Ausar Thompson,DET,68,1659,-239,109.8480420806546,115.98491441833478,494,0.23333333333333334,0.43529411764705883,0.3620689655172414,0.17391304347826086,62,56,6,26,29,1,0,6,29,0.46774193548387094,70,31,39,1
Frank Ntilikina,CHA,143,1657,64,111.49700598802396,108.3802191294048,427,0.22758620689655173,0.21212121212121213,0.3,0.13513513513513514,18,17,1,12,4,1,0,1,10,0.5555555555555556,61,18,43,0
Kessler Edwards,DAL,141,1656,-119,114.62333825701624,116.45311589982526,398,0.26582278481012656,0.4339622641509434,0.65625,0.29411764705882354,34,34,0,21,11,2,0,0,14,0.4117647058823529,53,28,25,3
Solomon Hill,ATL,84,1653,67,115.12781954887218,112.2016706443914,285,0.18543046357615894,0.3333333333333333,0.5333333333333333,0.5,13,13,0,6,6,1,0,0,11,0.8461538461538461,54,19,35,0
Rodney Hood,LAC,107,1652,-122,110.9982068141064,114.8502994011976,372,0.2462686567164179,0.1875,0.2698412698412698,0.2558139534883721,13,13,0,6,7,0,0,0,8,0.6153846153846154,39,12,27,0
Maurice Harkless,SAC,84,1635,-134,111.18362503708099,114.92007104795736,368,0.17829457364341086,0.36585365853658536,0.25,0.2,44,40,4,22,16,2,1,3,21,0.4772727272727273,59,19,40,2
Anthony Lamb,GSW,88,1618,-52,112.99084735754356,114.55995274660367,486,0.24277456647398843,0.34375,0.25925925925925924,0.2,25,23,2,10,12,1,0,2,17,0.68,34,9,25,2
Kris Murray,POR,83,1615,-215,107.4658573596358,114.44241316270566,379,0.31125827814569534,0.4576271186440678,0.5555555555555556,0,24,24,0,12,11,1,0,0,14,0.5833333333333334,62,18,44,1
Lindy Waters III,GSW,123,1609,97,113.58244365361803,112.50753465943339,577,0.24390243902439024,0.23076923076923078,0.47058823529411764,0.16666666666666666,31,30,1,16,14,0,0,1,17,0.5483870967741935,47,25,22,2
Bruno Fernando,TOR,162,1607,-247,107.58683729433272,114.72821135742484,472,0.18181818181818182,0.38235294117647056,0.33766233766233766,0.42857142857142855,85,85,0,49,35,1,0,0,53,0.6235294117647059,39,18,21,15
Edmond Sumner,BKN,106,1597,-8,114.77642878294343,114.74150664697193,705,0.18269230769230768,0.31868131868131866,0.2835820895522388,0.2,20,19,1,9,9,1,1,0,13,0.65,64,23,41,1
Vince Williams Jr.,MEM,70,1586,-111,109.48702101359703,113.0569306930693,468,0.18354430379746836,0.47619047619047616,0.4473684210526316,0.125,38,38,0,20,18,0,0,0,20,0.5263157894736842,53,28,25,0
AJ Griffin,ATL,92,1572,12,116.2656107219007,115.68865916692003,611,0.22527472527472528,0.5,0.3875,0.19444444444444445,14,13,1,7,5,1,0,1,7,0.5,43,15,28,0
Marcus Sasser,DET,87,1562,-259,109.20605498918752,117.06263498920087,641,0.23780487804878048,0.45454545454545453,0.3157894736842105,0.25,14,14,0,6,8,0,0,0,7,0.5,57,28,29,0
Keon Johnson,BKN,104,1547,-554,105.02225047679593,121.4353163361662,555,0.16091954022988506,0.35802469135802467,0.35802469135802467,0.13513513513513514,26,26,0,22,4,0,0,0,15,0.5769230769230769,62,19,43,4
PJ Dozier,MIN,91,1538,79,110.82307193778354,107.28965960179833,462,0.22695035460992907,0.45652173913043476,0.36363636363636365,0.225,29,28,1,14,14,0,0,1,19,0.6551724137931034,49,19,30,5
Paul Millsap,PHI,89,1538,79,116.41008843760235,113.63636363636364,513,0.21367521367521367,0.45161290322580644,0.36904761904761907,0.18181818181818182,49,49,0,23,25,1,0,0,24,0.4897959183673469,61,28,33,0
Vit Krejci,ATL,92,1529,-200,111.02210829862223,117.50561077268355,347,0.2265625,0.32,0.5161290322580645,0,18,18,0,7,11,0,0,0,10,0.5555555555555556,41,18,23,0
Keon Ellis,SAC,96,1521,146,118.28986464179597,112.50409165302781,439,0.2302158273381295,0.3157894736842105,0.2727272727272727,0.2727272727272727,49,46,3,20,23,3,0,3,30,0.6122448979591837,84,40,44,0
Trayce Jackson-Davis,GSW,89,1503,33,116.87763713080169,115.24547803617571,567,1,0.45263157894736844,0.34615384615384615,0,90,89,1,41,48,0,1,0,60,0.6666666666666666,35,8,27,11
Rodney McGruder,DET,99,1472,-117,110.92297476759627,114.46540880503144,477,0.2792207792207792,0.47058823529411764,0.3829787234042553,0.2222222222222222,9,9,0,6,3,0,0,0,6,0.6666666666666666,45,19,26,0
Armoni Brooks,BKN,84,1468,-187,110.1812191103789,116.45778364116094,498,0.24113475177304963,0.32,0.3076923076923077,0.25,17,16,1,6,9,1,0,1,7,0.4117647058823529,41,10,31,0
Rajon Rondo,CLE,84,1467,-87,106.63094440723376,110.02354524049781,404,0.24299065420560748,0.2711864406779661,0.25,0.18181818181818182,10,9,1,4,3,2,0,1,8,0.8,67,27,40,0
Jordan Hawkins,NOP,78,1463,-71,114.01527731650614,117.78151260504201,617,0.26956521739130435,0.39285714285714285,0.4318181818181818,0.2545454545454545,11,9,2,5,4,0,0,2,6,0.5454545454545454,22,10,12,1
Vasilije Micic,CHA,73,1459,-110,112.1808143547274,116.57995143947278,490,0.24427480916030533,0.33962264150943394,0.4666666666666667,0.1794871794871795,7,6,1,5,1,0,1,0,2,0.2857142857142857,38,10,28,0
Eric Paschall,UTA,98,1431,-142,109.29596719070403,113.72148450800135,627,0.18811881188118812,0.42857142857142855,0.16393442622950818,0.085714286,12,11,1,7,4,0,0,1,5,0.4166666666666667,21,8,13,2
DeMarcus Cousins,DEN,89,1430,-22,111.66041595635869,112.48720573183215,649,0.15789473684210525,0.39655172413793105,0.41304347826086957,0,45,45,0,25,20,0,0,0,26,0.5777777777777777,69,19,50,1
AJ Green,MIL,113,1414,70,115.81703910614524,113.73029772329247,519,0.1895734597156398,0.16666666666666666,0.2857142857142857,0.3125,5,5,0,2,3,0,0,0,2,0.4,27,14,13,0
Jonathan Isaac,ORL,90,1393,157,112.93134762077733,105.76854174131135,412,0.25,0.45,0.36666666666666664,0.25,103,100,3,53,41,6,0,3,57,0.5533980582524272,75,25,50,5
Thanasis Antetokounmpo,MIL,176,1386,-280,106.59530386740332,114.44595513256287,340,0.18181818181818182,0.28888888888888886,0.20689655172413793,0,29,27,2,18,8,1,0,2,19,0.6551724137931034,48,17,31,2
Vlatko Cancar,DEN,120,1381,-168,108.16112084063047,114.64788732394366,402,0.2127659574468085,0.32432432432432434,0.24324324324324326,0.3333333333333333,20,16,4,12,4,0,2,2,7,0.35,35,6,29,0
Brad Wanamaker,WAS,84,1373,-175,104.97118155619596,109.88971896122376,388,0.17721518987341772,0.42857142857142855,0.4,0.3142857142857143,17,15,2,4,11,0,0,2,10,0.5882352941176471,50,28,22,0
CJ Elleby,POR,88,1367,-363,104.55347687963291,117.86600496277916,340,0.22807017543859648,0.34,0.35714285714285715,0.10526315789473684,22,21,1,14,6,1,1,0,10,0.45454545454545453,41,16,25,0
Mark Williams,CHA,65,1366,-126,111.37491141034728,115.63494870887867,465,0,0.4175824175824176,0.2857142857142857,0,66,62,4,36,26,0,1,3,40,0.6060606060606061,45,10,35,20
Duane Washington Jr.,PHX,79,1362,-131,111.91310441485635,117.40819209039547,664,0.24731182795698925,0.3472222222222222,0.4431818181818182,0.29545454545454547,7,7,0,3,4,0,0,0,5,0.7142857142857143,32,14,18,0
Semi Ojeleye,LAC,86,1356,-139,107.5402635431918,111.93161149508913,290,0.208955224,0.3333333333333333,0.3409090909090909,0.2857142857142857,6,5,1,3,1,1,0,1,2,0.3333333333333333,24,9,15,0
Nikola Jovic,MIA,75,1355,117,114.93196027951453,111.32494448556625,502,0.17532467532467533,0.4358974358974359,0.2558139534883721,0.4,17,17,0,10,6,1,0,0,8,0.47058823529411764,45,13,32,2
Trey Burke,DAL,104,1355,2,112.00585651537335,111.8916941090377,582,0.25,0.24444444444444444,0.2553191489361702,0.13157894736842105,7,7,0,3,4,0,0,0,4,0.5714285714285714,48,16,32,0
MarJon Beauchamp,MIL,111,1343,-91,112,115.13972408914043,434,0.2535211267605634,0.22727272727272727,0.2222222222222222,0.2,14,14,0,8,5,1,0,0,8,0.5714285714285714,35,13,22,0
Ish Wainright,PHX,116,1336,127,112.12889210716871,106.64272890484739,317,0.29878048780487804,0.4642857142857143,0.42857142857142855,0.5,29,26,3,13,13,0,2,1,17,0.5862068965517241,62,23,39,0
Omer Yurtseven,UTA,113,1335,-60,111.89248895434463,114.56561922365988,399,0.18181818181818182,0.40298507462686567,0.23529411764705882,0.2727272727272727,40,40,0,21,19,0,0,0,23,0.575,27,3,24,1
Trevor Ariza,LAL,54,1303,-17,113.53412123522683,113.87832699619771,344,0.136986301,0.2926829268292683,0.26666666666666666,0.3333333333333333,24,20,4,11,6,3,1,3,11,0.4583333333333333,44,10,34,1
Duop Reath,POR,81,1297,-215,111.57531621310847,120.23076923076923,504,0.3048780487804878,0.49019607843137253,0.3220338983050847,0,40,38,2,22,14,2,1,1,32,0.8,33,13,20,0
David Nwaba,HOU,76,1288,-145,109.22563912560209,114.09074142382885,412,0.3076923076923077,0.35802469135802467,0.3170731707317073,0,41,38,3,23,15,0,2,1,14,0.34146341463414637,58,23,35,0
Gorgui Dieng,SAS,113,1282,-283,105.83112457402498,116.19479048697623,448,0.16030534351145037,0.3181818181818182,0.096774194,0.23809523809523808,43,42,1,29,13,0,0,1,29,0.6744186046511628,41,18,23,10
Tony Bradley,CHI,109,1266,65,112.95238095238095,110.14052411697683,359,0.2,0.36363636363636365,0.13513513513513514,0,64,64,0,49,14,1,0,0,38,0.59375,26,4,22,1
Denzel Valentine,UTA,86,1258,18,109.50155763239876,109.09800859039439,433,0.18617021276595744,0.6,0.29577464788732394,0.23076923076923078,7,7,0,5,1,1,0,0,3,0.42857142857142855,38,14,24,0
Jalen Wilson,BKN,66,1240,-33,115.52287581699346,117.01431492842536,346,0.2571428571428571,0.40540540540540543,0.3181818181818182,0,5,5,0,4,1,0,0,0,1,0.2,19,6,13,0
Daishen Nix,MIN,99,1239,-161,109.50896336710834,115.46832491255344,313,0.25806451612903225,0.48717948717948717,0.5555555555555556,0.6,7,7,0,4,3,0,0,0,2,0.2857142857142857,51,25,26,1
GG Jackson II,MEM,48,1233,-195,106.03174603174604,114.08674890569041,605,0.2,0.2923076923076923,0.2708333333333333,0.13636363636363635,24,22,2,13,9,0,0,2,18,0.75,28,9,19,5
Dalen Terry,CHI,122,1231,-34,112.1931908155186,112.69155206286837,323,0.2717391304347826,0.5957446808510638,0.2631578947368421,0.25,30,26,4,12,12,2,2,2,20,0.6666666666666666,52,25,27,1
Usman Garuba,GSW,105,1227,-232,109.98815633636005,117.84459195626708,184,0.13725490196078433,0.4772727272727273,0.30434782608695654,0,43,43,0,21,22,0,0,0,23,0.5348837209302325,55,35,20,3
Dante Exum,DAL,61,1204,245,122.28041901692184,112.09321012454801,408,0.25,0.35714285714285715,0.3076923076923077,0.16666666666666666,7,7,0,6,1,0,0,0,3,0.42857142857142855,26,9,17,0
Jared Butler,WAS,105,1182,-75,111.67205169628433,114.79385610347616,518,0.18181818181818182,0.5161290322580645,0.3466666666666667,0.2,18,18,0,9,9,0,0,0,8,0.4444444444444444,57,24,33,0
Johnny Davis,WAS,95,1178,-191,106.66134822497008,113.46534653465346,330,0.2891566265060241,0.4318181818181818,0.3620689655172414,0.1724137931034483,21,20,1,11,8,1,1,0,13,0.6190476190476191,37,15,22,1
Terry Taylor,CHI,95,1165,-80,114.2621599340478,117.02913418137054,306,0.2222222222222222,0.5357142857142857,0.35294117647058826,0,16,14,2,8,6,0,2,0,9,0.5625,22,7,15,0
Scotty Pippen Jr.,MEM,52,1142,-39,110.07493755203997,111.55925155925155,502,0.29069767441860467,0.3333333333333333,0.24242424242424243,0.25,19,16,3,5,11,0,0,3,12,0.631578947,66,33,33,0
Frank Kaminsky,HOU,92,1131,91,114.19939577039274,110.41486603284356,444,0.13580246913580246,0.3695652173913043,0.21568627450980393,0.076923077,28,28,0,17,11,0,0,0,13,0.4642857142857143,28,13,15,0
Brandon Goodwin,CLE,83,1121,-114,109.15269596737653,113.44424460431655,377,0.22916666666666666,0.37735849056603776,0.3469387755102041,0.3157894736842105,1,1,0,1,0,0,0,0,0,0,42,16,26,0
Ousmane Dieng,OKC,88,1119,67,111.72919361793876,108.60585197934596,336,0.3006993006993007,0.36,0.25,0,16,16,0,9,7,0,0,0,14,0.875,33,9,24,0
Skylar Mays,LAL,105,1111,-216,107.96304443466784,117.82877316857899,402,0.15730337078651685,0.4406779661016949,0.3333333333333333,0.3157894736842105,7,6,1,2,4,0,1,0,4,0.5714285714285714,48,25,23,0
Ben Sheppard,IND,70,1086,40,121.3368747233289,117.89611523352248,294,0.34814814814814815,0.43478260869565216,0.2222222222222222,1,6,6,0,1,5,0,0,0,4,0.6666666666666666,38,12,26,0
Joshua Primo,LAC,56,1069,-85,111.21664405246496,114.18312387791741,280,0.21212121212121213,0.41379310344827586,0.3611111111111111,0.2222222222222222,26,26,0,12,14,0,0,0,11,0.4230769230769231,21,4,17,2
Eugene Omoruyi,WAS,87,1057,-178,109.38069216757741,116.21621621621622,389,0.15789473684210525,0.36363636363636365,0.4,0.3333333333333333,8,7,1,3,3,1,0,1,3,0.375,55,31,24,0
